edition,edition_id,year,country,gold,silver,bronze,total,previous_medals,predicted_medals
1896 Summer Olympics,1,1896,United States,11,7,2,20,0.0,19.98
1896 Summer Olympics,1,1896,Greece,10,18,19,47,0.0,46.7
1896 Summer Olympics,1,1896,Germany,6,5,2,13,0.0,13.0
1896 Summer Olympics,1,1896,France,5,4,2,11,0.0,11.21
1896 Summer Olympics,1,1896,Great Britain,2,3,2,7,0.0,7.04
1896 Summer Olympics,1,1896,Hungary,2,1,3,6,0.0,6.0
1896 Summer Olympics,1,1896,Austria,2,1,2,5,0.0,5.03
1896 Summer Olympics,1,1896,Australia,2,0,0,2,0.0,2.01
1896 Summer Olympics,1,1896,Denmark,1,2,3,6,0.0,6.0
1896 Summer Olympics,1,1896,Switzerland,1,2,0,3,0.0,3.0
1896 Summer Olympics,1,1896,Mixed team,1,0,1,2,0.0,2.0
1900 Summer Olympics,2,1900,France,31,41,40,112,11.0,105.17
1900 Summer Olympics,2,1900,United States,20,13,15,48,20.0,49.02
1900 Summer Olympics,2,1900,Great Britain,20,8,9,37,7.0,38.14
1900 Summer Olympics,2,1900,Belgium,6,6,6,18,0.0,18.04
1900 Summer Olympics,2,1900,Switzerland,6,3,1,10,3.0,10.53
1900 Summer Olympics,2,1900,Germany,4,3,2,9,13.0,8.82
1900 Summer Olympics,2,1900,Italy,3,2,0,5,0.0,5.32
1900 Summer Olympics,2,1900,Denmark,1,3,2,6,6.0,6.01
1900 Summer Olympics,2,1900,Mixed team,1,2,3,6,2.0,6.01
1900 Summer Olympics,2,1900,Netherlands,1,2,3,6,0.0,6.0
1900 Summer Olympics,2,1900,Hungary,1,2,2,5,6.0,5.01
1900 Summer Olympics,2,1900,Cuba,1,1,0,2,0.0,2.0
1900 Summer Olympics,2,1900,Spain,1,0,0,1,0.0,1.0
1900 Summer Olympics,2,1900,Austria,0,3,3,6,5.0,6.0
1900 Summer Olympics,2,1900,Norway,0,2,3,5,0.0,5.06
1900 Summer Olympics,2,1900,India,0,2,0,2,0.0,2.0
1900 Summer Olympics,2,1900,Bohemia,0,1,1,2,0.0,2.0
1900 Summer Olympics,2,1900,Australia,0,0,3,3,2.0,3.0
1900 Summer Olympics,2,1900,Sweden,0,0,1,1,0.0,1.01
1904 Summer Olympics,3,1904,United States,80,85,83,248,48.0,171.69
1904 Summer Olympics,3,1904,Germany,5,4,5,14,9.0,14.03
1904 Summer Olympics,3,1904,Canada,4,1,1,6,0.0,6.0
1904 Summer Olympics,3,1904,Cuba,3,0,0,3,2.0,3.04
1904 Summer Olympics,3,1904,Hungary,2,1,1,4,5.0,4.0
1904 Summer Olympics,3,1904,Great Britain,1,1,0,2,37.0,2.0
1904 Summer Olympics,3,1904,Greece,1,0,1,2,47.0,2.0
1904 Summer Olympics,3,1904,Mixed team,1,0,0,1,6.0,1.0
1908 Summer Olympics,5,1908,Great Britain,56,51,39,146,2.0,147.05
1908 Summer Olympics,5,1908,United States,23,12,12,47,248.0,46.84
1908 Summer Olympics,5,1908,Sweden,8,6,11,25,1.0,24.77
1908 Summer Olympics,5,1908,France,5,5,9,19,112.0,19.11
1908 Summer Olympics,5,1908,Germany,3,5,5,13,14.0,13.1
1908 Summer Olympics,5,1908,Hungary,3,4,2,9,4.0,9.15
1908 Summer Olympics,5,1908,Canada,3,3,10,16,6.0,16.32
1908 Summer Olympics,5,1908,Norway,2,3,3,8,5.0,8.01
1908 Summer Olympics,5,1908,Italy,2,2,0,4,5.0,4.11
1908 Summer Olympics,5,1908,Belgium,1,5,2,8,18.0,8.03
1908 Summer Olympics,5,1908,Australasia,1,2,2,5,0.0,5.01
1908 Summer Olympics,5,1908,Russian Federation,1,2,0,3,0.0,3.0
1908 Summer Olympics,5,1908,Finland,1,1,3,5,0.0,5.03
1908 Summer Olympics,5,1908,South Africa,1,1,0,2,0.0,2.0
1908 Summer Olympics,5,1908,Greece,0,3,1,4,2.0,4.0
1908 Summer Olympics,5,1908,Denmark,0,2,3,5,6.0,5.0
1908 Summer Olympics,5,1908,Bohemia,0,0,2,2,2.0,2.0
1908 Summer Olympics,5,1908,Netherlands,0,0,2,2,6.0,2.0
1908 Summer Olympics,5,1908,Austria,0,0,1,1,6.0,1.01
1912 Summer Olympics,6,1912,United States,26,19,19,64,47.0,63.17
1912 Summer Olympics,6,1912,Sweden,23,25,17,65,25.0,63.47
1912 Summer Olympics,6,1912,Great Britain,10,15,16,41,146.0,43.48
1912 Summer Olympics,6,1912,Finland,9,8,9,26,5.0,25.78
1912 Summer Olympics,6,1912,France,7,5,3,15,19.0,15.05
1912 Summer Olympics,6,1912,Germany,6,13,7,26,13.0,24.98
1912 Summer Olympics,6,1912,Italy,5,1,2,8,4.0,8.34
1912 Summer Olympics,6,1912,South Africa,4,2,0,6,2.0,6.06
1912 Summer Olympics,6,1912,Norway,3,2,5,10,8.0,10.32
1912 Summer Olympics,6,1912,Canada,3,2,3,8,16.0,8.01
1912 Summer Olympics,6,1912,Hungary,3,2,3,8,9.0,8.02
1912 Summer Olympics,6,1912,Australasia,2,2,3,7,5.0,7.02
1912 Summer Olympics,6,1912,Belgium,2,1,3,6,8.0,5.99
1912 Summer Olympics,6,1912,Denmark,1,6,5,12,5.0,14.13
1912 Summer Olympics,6,1912,Greece,1,0,1,2,4.0,2.0
1912 Summer Olympics,6,1912,Switzerland,1,0,0,1,10.0,1.0
1912 Summer Olympics,6,1912,Russian Federation,0,2,3,5,3.0,5.11
1912 Summer Olympics,6,1912,Austria,0,2,2,4,1.0,4.07
1912 Summer Olympics,6,1912,Netherlands,0,0,3,3,2.0,3.0
1920 Summer Olympics,7,1920,United States,41,27,27,95,64.0,93.54
1920 Summer Olympics,7,1920,Sweden,19,20,25,64,65.0,63.92
1920 Summer Olympics,7,1920,Belgium,16,12,14,42,6.0,41.92
1920 Summer Olympics,7,1920,Finland,15,10,9,34,26.0,33.12
1920 Summer Olympics,7,1920,Great Britain,14,16,13,43,41.0,43.57
1920 Summer Olympics,7,1920,Italy,14,6,5,25,8.0,24.35
1920 Summer Olympics,7,1920,Norway,13,10,9,32,10.0,32.05
1920 Summer Olympics,7,1920,France,9,20,13,42,15.0,42.53
1920 Summer Olympics,7,1920,Netherlands,4,2,5,11,3.0,10.88
1920 Summer Olympics,7,1920,Denmark,3,9,1,13,12.0,12.38
1920 Summer Olympics,7,1920,South Africa,3,4,3,10,6.0,10.0
1920 Summer Olympics,7,1920,Canada,3,3,3,9,8.0,9.02
1920 Summer Olympics,7,1920,Switzerland,2,2,7,11,1.0,11.05
1920 Summer Olympics,7,1920,Estonia,1,2,0,3,0.0,3.0
1920 Summer Olympics,7,1920,Brazil,1,1,1,3,0.0,3.0
1920 Summer Olympics,7,1920,Australia,0,2,1,3,3.0,3.03
1920 Summer Olympics,7,1920,Japan,0,2,0,2,0.0,2.0
1920 Summer Olympics,7,1920,Spain,0,2,0,2,1.0,2.0
1920 Summer Olympics,7,1920,Greece,0,1,0,1,2.0,1.0
1920 Summer Olympics,7,1920,Luxembourg,0,1,0,1,0.0,1.0
1920 Summer Olympics,7,1920,Czechoslovakia,0,0,2,2,0.0,2.0
1920 Summer Olympics,7,1920,New Zealand,0,0,1,1,0.0,1.0
1924 Summer Olympics,8,1924,United States,45,27,27,99,95.0,98.64
1924 Summer Olympics,8,1924,France,14,15,12,41,42.0,41.25
1924 Summer Olympics,8,1924,Finland,14,13,10,37,34.0,33.75
1924 Summer Olympics,8,1924,Great Britain,9,14,12,35,43.0,33.58
1924 Summer Olympics,8,1924,Italy,8,3,5,16,25.0,16.17
1924 Summer Olympics,8,1924,Switzerland,7,8,10,25,11.0,24.73
1924 Summer Olympics,8,1924,Norway,5,2,3,10,32.0,10.34
1924 Summer Olympics,8,1924,Sweden,4,13,12,29,64.0,29.72
1924 Summer Olympics,8,1924,Netherlands,4,1,6,11,11.0,11.13
1924 Summer Olympics,8,1924,Belgium,3,7,3,13,42.0,12.59
1924 Summer Olympics,8,1924,Australia,3,1,2,6,3.0,5.94
1924 Summer Olympics,8,1924,Denmark,2,6,3,11,13.0,11.22
1924 Summer Olympics,8,1924,Hungary,2,4,4,10,8.0,9.93
1924 Summer Olympics,8,1924,Yugoslavia,2,0,0,2,0.0,2.01
1924 Summer Olympics,8,1924,Czechoslovakia,1,4,5,10,2.0,10.09
1924 Summer Olympics,8,1924,Argentina,1,3,2,6,0.0,5.97
1924 Summer Olympics,8,1924,Estonia,1,1,4,6,3.0,6.06
1924 Summer Olympics,8,1924,South Africa,1,1,1,3,10.0,3.0
1924 Summer Olympics,8,1924,Luxembourg,1,1,0,2,1.0,2.0
1924 Summer Olympics,8,1924,Greece,1,0,0,1,1.0,1.0
1924 Summer Olympics,8,1924,Uruguay,1,0,0,1,0.0,1.0
1924 Summer Olympics,8,1924,Austria,0,3,1,4,4.0,4.02
1924 Summer Olympics,8,1924,Canada,0,3,1,4,9.0,4.07
1924 Summer Olympics,8,1924,Ireland,0,1,1,2,0.0,2.0
1924 Summer Olympics,8,1924,Poland,0,1,1,2,0.0,2.0
1924 Summer Olympics,8,1924,Haiti,0,0,1,1,0.0,1.0
1924 Summer Olympics,8,1924,Japan,0,0,1,1,2.0,1.0
1924 Summer Olympics,8,1924,Monaco,0,0,1,1,0.0,1.0
1924 Summer Olympics,8,1924,New Zealand,0,0,1,1,1.0,1.0
1924 Summer Olympics,8,1924,Portugal,0,0,1,1,0.0,1.0
1924 Summer Olympics,8,1924,Romania,0,0,1,1,0.0,1.0
1928 Summer Olympics,9,1928,United States,22,18,16,56,99.0,57.54
1928 Summer Olympics,9,1928,Germany,11,9,19,39,26.0,39.14
1928 Summer Olympics,9,1928,Netherlands,8,10,5,23,11.0,23.57
1928 Summer Olympics,9,1928,Finland,8,8,9,25,37.0,24.88
1928 Summer Olympics,9,1928,France,7,12,6,25,41.0,24.68
1928 Summer Olympics,9,1928,Sweden,7,6,12,25,29.0,25.42
1928 Summer Olympics,9,1928,Italy,7,6,7,20,16.0,20.36
1928 Summer Olympics,9,1928,Switzerland,7,6,4,17,25.0,17.16
1928 Summer Olympics,9,1928,Hungary,5,5,0,10,10.0,11.02
1928 Summer Olympics,9,1928,Great Britain,4,11,7,22,35.0,22.14
1928 Summer Olympics,9,1928,Canada,4,4,7,15,4.0,14.47
1928 Summer Olympics,9,1928,Argentina,3,3,1,7,6.0,6.94
1928 Summer Olympics,9,1928,Denmark,3,2,4,9,11.0,8.9
1928 Summer Olympics,9,1928,Austria,3,0,1,4,4.0,4.11
1928 Summer Olympics,9,1928,Czechoslovakia,2,5,2,9,10.0,8.98
1928 Summer Olympics,9,1928,Japan,2,2,1,5,1.0,4.98
1928 Summer Olympics,9,1928,Poland,2,1,4,7,2.0,6.69
1928 Summer Olympics,9,1928,Estonia,2,1,2,5,6.0,5.02
1928 Summer Olympics,9,1928,Egypt,2,1,1,4,0.0,4.0
1928 Summer Olympics,9,1928,Australia,1,2,1,4,6.0,4.0
1928 Summer Olympics,9,1928,Norway,1,2,1,4,10.0,4.0
1928 Summer Olympics,9,1928,Yugoslavia,1,1,3,5,2.0,5.01
1928 Summer Olympics,9,1928,South Africa,1,0,2,3,3.0,3.0
1928 Summer Olympics,9,1928,India,1,0,0,1,2.0,1.0
1928 Summer Olympics,9,1928,Ireland,1,0,0,1,2.0,1.0
1928 Summer Olympics,9,1928,Luxembourg,1,0,0,1,2.0,1.0
1928 Summer Olympics,9,1928,New Zealand,1,0,0,1,1.0,1.0
1928 Summer Olympics,9,1928,Spain,1,0,0,1,2.0,1.0
1928 Summer Olympics,9,1928,Uruguay,1,0,0,1,1.0,1.0
1928 Summer Olympics,9,1928,Belgium,0,1,2,3,13.0,3.0
1928 Summer Olympics,9,1928,Chile,0,1,0,1,0.0,1.0
1928 Summer Olympics,9,1928,Haiti,0,1,0,1,1.0,1.0
1928 Summer Olympics,9,1928,Philippines,0,0,1,1,0.0,1.0
1928 Summer Olympics,9,1928,Portugal,0,0,1,1,1.0,1.0
1932 Summer Olympics,10,1932,United States,44,36,30,110,56.0,101.41
1932 Summer Olympics,10,1932,Italy,12,12,12,36,20.0,35.1
1932 Summer Olympics,10,1932,France,11,5,4,20,25.0,19.26
1932 Summer Olympics,10,1932,Sweden,10,5,9,24,25.0,24.13
1932 Summer Olympics,10,1932,Japan,7,7,4,18,5.0,17.61
1932 Summer Olympics,10,1932,Hungary,6,5,5,16,10.0,16.32
1932 Summer Olympics,10,1932,Germany,5,12,7,24,39.0,23.76
1932 Summer Olympics,10,1932,Finland,5,8,12,25,25.0,25.4
1932 Summer Olympics,10,1932,Great Britain,5,7,5,17,22.0,17.07
1932 Summer Olympics,10,1932,Poland,3,2,4,9,7.0,8.88
1932 Summer Olympics,10,1932,Australia,3,1,1,5,4.0,5.0
1932 Summer Olympics,10,1932,Argentina,3,1,0,4,7.0,3.93
1932 Summer Olympics,10,1932,Canada,2,5,9,16,15.0,17.12
1932 Summer Olympics,10,1932,Netherlands,2,5,1,8,23.0,8.06
1932 Summer Olympics,10,1932,South Africa,2,0,3,5,3.0,5.19
1932 Summer Olympics,10,1932,Ireland,2,0,0,2,1.0,2.01
1932 Summer Olympics,10,1932,Czechoslovakia,1,3,2,6,9.0,6.06
1932 Summer Olympics,10,1932,Austria,1,1,3,5,4.0,5.01
1932 Summer Olympics,10,1932,India,1,0,0,1,1.0,1.0
1932 Summer Olympics,10,1932,Denmark,0,5,3,8,9.0,8.36
1932 Summer Olympics,10,1932,Mexico,0,2,0,2,0.0,2.0
1932 Summer Olympics,10,1932,Latvia,0,1,0,1,0.0,1.0
1932 Summer Olympics,10,1932,New Zealand,0,1,0,1,1.0,1.0
1932 Summer Olympics,10,1932,Switzerland,0,1,0,1,17.0,1.0
1932 Summer Olympics,10,1932,Philippines,0,0,3,3,1.0,3.0
1932 Summer Olympics,10,1932,Belgium,0,0,1,1,3.0,1.0
1932 Summer Olympics,10,1932,Spain,0,0,1,1,1.0,1.0
1932 Summer Olympics,10,1932,Uruguay,0,0,1,1,1.0,1.0
1936 Summer Olympics,11,1936,Germany,38,31,32,101,24.0,97.68
1936 Summer Olympics,11,1936,United States,24,21,12,57,110.0,58.95
1936 Summer Olympics,11,1936,Hungary,10,1,5,16,16.0,16.35
1936 Summer Olympics,11,1936,Italy,9,13,5,27,36.0,26.32
1936 Summer Olympics,11,1936,Finland,8,6,6,20,25.0,20.06
1936 Summer Olympics,11,1936,France,7,6,6,19,20.0,19.18
1936 Summer Olympics,11,1936,Sweden,6,5,10,21,24.0,21.05
1936 Summer Olympics,11,1936,Japan,6,4,10,20,18.0,19.82
1936 Summer Olympics,11,1936,Netherlands,6,4,7,17,8.0,16.36
1936 Summer Olympics,11,1936,Austria,5,7,5,17,5.0,17.04
1936 Summer Olympics,11,1936,Switzerland,4,9,5,18,1.0,18.24
1936 Summer Olympics,11,1936,Great Britain,4,7,3,14,17.0,13.58
1936 Summer Olympics,11,1936,Czechoslovakia,3,5,1,9,6.0,8.8
1936 Summer Olympics,11,1936,Argentina,2,2,3,7,4.0,6.98
1936 Summer Olympics,11,1936,Estonia,2,2,3,7,5.0,7.01
1936 Summer Olympics,11,1936,Egypt,2,1,2,5,4.0,5.0
1936 Summer Olympics,11,1936,Canada,1,3,5,9,16.0,9.09
1936 Summer Olympics,11,1936,Norway,1,3,2,6,4.0,6.0
1936 Summer Olympics,11,1936,Türkiye,1,0,1,2,0.0,2.0
1936 Summer Olympics,11,1936,India,1,0,0,1,1.0,1.0
1936 Summer Olympics,11,1936,New Zealand,1,0,0,1,1.0,1.0
1936 Summer Olympics,11,1936,Poland,0,4,5,9,9.0,9.49
1936 Summer Olympics,11,1936,Denmark,0,2,3,5,8.0,5.0
1936 Summer Olympics,11,1936,Latvia,0,1,1,2,1.0,2.0
1936 Summer Olympics,11,1936,Romania,0,1,0,1,1.0,1.0
1936 Summer Olympics,11,1936,South Africa,0,1,0,1,5.0,1.0
1936 Summer Olympics,11,1936,Yugoslavia,0,1,0,1,5.0,1.0
1936 Summer Olympics,11,1936,Belgium,0,0,3,3,1.0,3.0
1936 Summer Olympics,11,1936,Mexico,0,0,3,3,2.0,3.0
1936 Summer Olympics,11,1936,Australia,0,0,1,1,5.0,1.0
1936 Summer Olympics,11,1936,Philippines,0,0,1,1,3.0,1.0
1936 Summer Olympics,11,1936,Portugal,0,0,1,1,1.0,1.0
1948 Summer Olympics,12,1948,United States,38,27,19,84,57.0,86.45
1948 Summer Olympics,12,1948,Sweden,17,11,18,46,21.0,45.59
1948 Summer Olympics,12,1948,France,11,6,15,32,19.0,32.07
1948 Summer Olympics,12,1948,Finland,10,8,6,24,20.0,24.24
1948 Summer Olympics,12,1948,Hungary,10,5,13,28,16.0,27.83
1948 Summer Olympics,12,1948,Italy,9,12,10,31,27.0,29.87
1948 Summer Olympics,12,1948,Türkiye,6,4,2,12,2.0,11.99
1948 Summer Olympics,12,1948,Czechoslovakia,6,2,3,11,9.0,10.87
1948 Summer Olympics,12,1948,Switzerland,5,12,6,23,18.0,22.78
1948 Summer Olympics,12,1948,Denmark,5,8,9,22,5.0,21.3
1948 Summer Olympics,12,1948,Netherlands,5,2,9,16,17.0,16.61
1948 Summer Olympics,12,1948,Great Britain,4,16,7,27,14.0,26.93
1948 Summer Olympics,12,1948,Argentina,3,3,1,7,7.0,7.01
1948 Summer Olympics,12,1948,Australia,2,6,5,13,1.0,14.22
1948 Summer Olympics,12,1948,Austria,2,2,4,8,17.0,8.02
1948 Summer Olympics,12,1948,Belgium,2,2,3,7,3.0,6.99
1948 Summer Olympics,12,1948,South Africa,2,2,2,6,1.0,6.13
1948 Summer Olympics,12,1948,Egypt,2,2,1,5,5.0,4.98
1948 Summer Olympics,12,1948,Mexico,2,1,2,5,3.0,5.0
1948 Summer Olympics,12,1948,Norway,1,3,3,7,6.0,7.1
1948 Summer Olympics,12,1948,Jamaica,1,2,0,3,0.0,3.0
1948 Summer Olympics,12,1948,Poland,1,0,1,2,9.0,2.0
1948 Summer Olympics,12,1948,India,1,0,0,1,1.0,1.0
1948 Summer Olympics,12,1948,Peru,1,0,0,1,0.0,1.0
1948 Summer Olympics,12,1948,Canada,0,2,2,4,9.0,4.06
1948 Summer Olympics,12,1948,Yugoslavia,0,2,0,2,1.0,2.0
1948 Summer Olympics,12,1948,Portugal,0,1,1,2,1.0,2.0
1948 Summer Olympics,12,1948,Uruguay,0,1,1,2,1.0,2.0
1948 Summer Olympics,12,1948,Cuba,0,1,0,1,3.0,1.0
1948 Summer Olympics,12,1948,Spain,0,1,0,1,1.0,1.0
1948 Summer Olympics,12,1948,Sri Lanka,0,1,0,1,0.0,1.0
1948 Summer Olympics,12,1948,Trinidad and Tobago,0,1,0,1,0.0,1.0
1948 Summer Olympics,12,1948,Panama,0,0,2,2,0.0,2.0
1948 Summer Olympics,12,1948,Republic of Korea,0,0,2,2,0.0,2.0
1948 Summer Olympics,12,1948,Brazil,0,0,1,1,3.0,1.0
1948 Summer Olympics,12,1948,Ireland,0,0,1,1,2.0,1.0
1948 Summer Olympics,12,1948,Islamic Republic of Iran,0,0,1,1,0.0,1.0
1948 Summer Olympics,12,1948,Puerto Rico,0,0,1,1,0.0,1.0
1952 Summer Olympics,13,1952,United States,40,19,17,76,84.0,83.39
1952 Summer Olympics,13,1952,Soviet Union,22,30,19,71,0.0,70.93
1952 Summer Olympics,13,1952,Hungary,16,10,16,42,28.0,42.34
1952 Summer Olympics,13,1952,Sweden,12,13,10,35,46.0,33.34
1952 Summer Olympics,13,1952,Italy,8,9,4,21,31.0,21.01
1952 Summer Olympics,13,1952,Czechoslovakia,7,3,3,13,11.0,12.95
1952 Summer Olympics,13,1952,France,6,6,6,18,32.0,18.39
1952 Summer Olympics,13,1952,Finland,6,3,13,22,24.0,21.83
1952 Summer Olympics,13,1952,Australia,6,2,3,11,13.0,10.87
1952 Summer Olympics,13,1952,Norway,3,2,0,5,7.0,5.45
1952 Summer Olympics,13,1952,Switzerland,2,6,6,14,23.0,14.75
1952 Summer Olympics,13,1952,South Africa,2,4,4,10,6.0,9.88
1952 Summer Olympics,13,1952,Jamaica,2,3,0,5,3.0,5.12
1952 Summer Olympics,13,1952,Belgium,2,2,0,4,7.0,4.11
1952 Summer Olympics,13,1952,Denmark,2,1,3,6,22.0,6.07
1952 Summer Olympics,13,1952,Türkiye,2,0,1,3,12.0,3.0
1952 Summer Olympics,13,1952,Japan,1,6,2,9,20.0,9.33
1952 Summer Olympics,13,1952,Great Britain,1,2,8,11,27.0,10.59
1952 Summer Olympics,13,1952,Argentina,1,2,2,5,7.0,5.02
1952 Summer Olympics,13,1952,Poland,1,2,1,4,2.0,4.0
1952 Summer Olympics,13,1952,Canada,1,2,0,3,4.0,3.0
1952 Summer Olympics,13,1952,Yugoslavia,1,2,0,3,2.0,3.0
1952 Summer Olympics,13,1952,Romania,1,1,2,4,1.0,4.0
1952 Summer Olympics,13,1952,Brazil,1,0,2,3,1.0,3.0
1952 Summer Olympics,13,1952,New Zealand,1,0,2,3,1.0,3.0
1952 Summer Olympics,13,1952,India,1,0,1,2,1.0,2.0
1952 Summer Olympics,13,1952,Luxembourg,1,0,0,1,1.0,1.0
1952 Summer Olympics,13,1952,Germany,0,7,17,24,101.0,25.54
1952 Summer Olympics,13,1952,Netherlands,0,5,0,5,16.0,5.25
1952 Summer Olympics,13,1952,Islamic Republic of Iran,0,3,4,7,1.0,7.03
1952 Summer Olympics,13,1952,Chile,0,2,0,2,1.0,2.0
1952 Summer Olympics,13,1952,Austria,0,1,1,2,8.0,1.99
1952 Summer Olympics,13,1952,Lebanon,0,1,1,2,0.0,2.0
1952 Summer Olympics,13,1952,Ireland,0,1,0,1,1.0,1.0
1952 Summer Olympics,13,1952,Mexico,0,1,0,1,5.0,1.0
1952 Summer Olympics,13,1952,Spain,0,1,0,1,1.0,1.0
1952 Summer Olympics,13,1952,Republic of Korea,0,0,2,2,2.0,2.0
1952 Summer Olympics,13,1952,Trinidad and Tobago,0,0,2,2,1.0,2.0
1952 Summer Olympics,13,1952,Uruguay,0,0,2,2,2.0,2.0
1952 Summer Olympics,13,1952,Bulgaria,0,0,1,1,0.0,1.0
1952 Summer Olympics,13,1952,Egypt,0,0,1,1,5.0,1.0
1952 Summer Olympics,13,1952,Portugal,0,0,1,1,2.0,1.0
1952 Summer Olympics,13,1952,Venezuela,0,0,1,1,0.0,1.0
1956 Summer Olympics,14,1956,Soviet Union,37,29,32,98,71.0,96.33
1956 Summer Olympics,14,1956,United States,32,25,17,74,76.0,77.85
1956 Summer Olympics,14,1956,Australia,13,8,14,35,11.0,33.39
1956 Summer Olympics,14,1956,Hungary,9,10,7,26,42.0,26.14
1956 Summer Olympics,14,1956,Italy,8,6,8,22,21.0,21.91
1956 Summer Olympics,14,1956,Great Britain,5,7,9,21,11.0,19.92
1956 Summer Olympics,14,1956,Sweden,5,5,6,16,35.0,15.92
1956 Summer Olympics,14,1956,Romania,5,3,5,13,4.0,13.22
1956 Summer Olympics,14,1956,Germany,4,10,6,20,24.0,20.53
1956 Summer Olympics,14,1956,Japan,4,10,5,19,9.0,19.07
1956 Summer Olympics,14,1956,France,4,4,6,14,18.0,13.79
1956 Summer Olympics,14,1956,Türkiye,3,2,2,7,3.0,6.99
1956 Summer Olympics,14,1956,Finland,3,1,11,15,22.0,16.83
1956 Summer Olympics,14,1956,Islamic Republic of Iran,2,2,1,5,7.0,4.98
1956 Summer Olympics,14,1956,Canada,2,1,2,5,3.0,5.0
1956 Summer Olympics,14,1956,New Zealand,2,0,0,2,3.0,2.0
1956 Summer Olympics,14,1956,Poland,1,4,4,9,4.0,8.89
1956 Summer Olympics,14,1956,Czechoslovakia,1,4,1,6,13.0,5.92
1956 Summer Olympics,14,1956,Bulgaria,1,3,1,5,1.0,4.99
1956 Summer Olympics,14,1956,Ireland,1,1,3,5,1.0,5.0
1956 Summer Olympics,14,1956,Denmark,1,1,1,3,6.0,3.0
1956 Summer Olympics,14,1956,Norway,1,0,2,3,5.0,3.0
1956 Summer Olympics,14,1956,Mexico,1,0,1,2,1.0,2.0
1956 Summer Olympics,14,1956,Brazil,1,0,0,1,3.0,1.0
1956 Summer Olympics,14,1956,India,1,0,0,1,2.0,1.0
1956 Summer Olympics,14,1956,Yugoslavia,0,3,0,3,3.0,3.29
1956 Summer Olympics,14,1956,Chile,0,2,2,4,2.0,4.05
1956 Summer Olympics,14,1956,Belgium,0,2,0,2,4.0,2.0
1956 Summer Olympics,14,1956,Argentina,0,1,1,2,5.0,2.0
1956 Summer Olympics,14,1956,Republic of Korea,0,1,1,2,2.0,2.0
1956 Summer Olympics,14,1956,Iceland,0,1,0,1,0.0,1.0
1956 Summer Olympics,14,1956,Pakistan,0,1,0,1,0.0,1.0
1956 Summer Olympics,14,1956,South Africa,0,0,4,4,10.0,3.99
1956 Summer Olympics,14,1956,Austria,0,0,2,2,2.0,2.0
1956 Summer Olympics,14,1956,Greece,0,0,1,1,1.0,1.0
1956 Summer Olympics,14,1956,The Bahamas,0,0,1,1,0.0,1.0
1956 Summer Olympics,14,1956,Uruguay,0,0,1,1,2.0,1.0
1960 Summer Olympics,15,1960,Soviet Union,43,29,31,103,98.0,101.33
1960 Summer Olympics,15,1960,United States,34,21,16,71,74.0,79.05
1960 Summer Olympics,15,1960,Italy,13,10,13,36,22.0,35.83
1960 Summer Olympics,15,1960,Germany,12,19,11,42,20.0,41.67
1960 Summer Olympics,15,1960,Australia,8,8,6,22,35.0,22.11
1960 Summer Olympics,15,1960,Türkiye,7,2,0,9,7.0,9.05
1960 Summer Olympics,15,1960,Hungary,6,8,7,21,26.0,21.13
1960 Summer Olympics,15,1960,Japan,4,7,7,18,19.0,17.56
1960 Summer Olympics,15,1960,Poland,4,6,11,21,9.0,21.86
1960 Summer Olympics,15,1960,Czechoslovakia,3,2,3,8,6.0,7.98
1960 Summer Olympics,15,1960,Romania,3,1,6,10,13.0,10.79
1960 Summer Olympics,15,1960,Great Britain,2,6,12,20,21.0,23.12
1960 Summer Olympics,15,1960,Denmark,2,3,1,6,3.0,5.77
1960 Summer Olympics,15,1960,New Zealand,2,0,1,3,2.0,3.0
1960 Summer Olympics,15,1960,Bulgaria,1,3,3,7,5.0,7.1
1960 Summer Olympics,15,1960,Sweden,1,2,3,6,16.0,6.01
1960 Summer Olympics,15,1960,Finland,1,1,3,5,15.0,5.0
1960 Summer Olympics,15,1960,Austria,1,1,0,2,2.0,2.0
1960 Summer Olympics,15,1960,Yugoslavia,1,1,0,2,3.0,2.0
1960 Summer Olympics,15,1960,Pakistan,1,0,1,2,1.0,2.0
1960 Summer Olympics,15,1960,Ethiopia,1,0,0,1,0.0,1.0
1960 Summer Olympics,15,1960,Greece,1,0,0,1,1.0,1.0
1960 Summer Olympics,15,1960,Norway,1,0,0,1,3.0,1.0
1960 Summer Olympics,15,1960,Switzerland,0,3,3,6,14.0,6.01
1960 Summer Olympics,15,1960,France,0,2,3,5,14.0,5.04
1960 Summer Olympics,15,1960,Belgium,0,2,2,4,2.0,4.06
1960 Summer Olympics,15,1960,Islamic Republic of Iran,0,1,3,4,5.0,4.06
1960 Summer Olympics,15,1960,Netherlands,0,1,2,3,5.0,3.0
1960 Summer Olympics,15,1960,South Africa,0,1,2,3,4.0,3.0
1960 Summer Olympics,15,1960,Argentina,0,1,1,2,2.0,2.0
1960 Summer Olympics,15,1960,United Arab Republic,0,1,1,2,0.0,2.0
1960 Summer Olympics,15,1960,Canada,0,1,0,1,5.0,1.0
1960 Summer Olympics,15,1960,Chinese Taipei,0,1,0,1,0.0,1.0
1960 Summer Olympics,15,1960,Ghana,0,1,0,1,0.0,1.0
1960 Summer Olympics,15,1960,India,0,1,0,1,1.0,1.0
1960 Summer Olympics,15,1960,Morocco,0,1,0,1,0.0,1.0
1960 Summer Olympics,15,1960,Portugal,0,1,0,1,1.0,1.0
1960 Summer Olympics,15,1960,Singapore,0,1,0,1,0.0,1.0
1960 Summer Olympics,15,1960,Brazil,0,0,2,2,1.0,2.0
1960 Summer Olympics,15,1960,West Indies Federation,0,0,2,2,0.0,2.0
1960 Summer Olympics,15,1960,Iraq,0,0,1,1,0.0,1.0
1960 Summer Olympics,15,1960,Mexico,0,0,1,1,2.0,1.0
1960 Summer Olympics,15,1960,Spain,0,0,1,1,1.0,1.0
1960 Summer Olympics,15,1960,Venezuela,0,0,1,1,1.0,1.0
1964 Summer Olympics,16,1964,United States,36,26,28,90,71.0,91.14
1964 Summer Olympics,16,1964,Soviet Union,30,31,35,96,103.0,95.54
1964 Summer Olympics,16,1964,Japan,16,5,8,29,18.0,31.21
1964 Summer Olympics,16,1964,Germany,10,22,18,50,42.0,48.37
1964 Summer Olympics,16,1964,Italy,10,10,7,27,36.0,27.04
1964 Summer Olympics,16,1964,Hungary,10,7,5,22,21.0,22.38
1964 Summer Olympics,16,1964,Poland,7,6,10,23,21.0,22.77
1964 Summer Olympics,16,1964,Australia,6,2,10,18,22.0,18.81
1964 Summer Olympics,16,1964,Czechoslovakia,5,6,3,14,8.0,13.66
1964 Summer Olympics,16,1964,Great Britain,4,12,2,18,20.0,14.56
1964 Summer Olympics,16,1964,Bulgaria,3,5,2,10,7.0,9.76
1964 Summer Olympics,16,1964,Finland,3,0,2,5,5.0,5.11
1964 Summer Olympics,16,1964,New Zealand,3,0,2,5,3.0,5.02
1964 Summer Olympics,16,1964,Romania,2,4,6,12,10.0,11.64
1964 Summer Olympics,16,1964,Netherlands,2,4,4,10,3.0,9.81
1964 Summer Olympics,16,1964,Türkiye,2,3,1,6,9.0,6.04
1964 Summer Olympics,16,1964,Sweden,2,2,4,8,6.0,7.97
1964 Summer Olympics,16,1964,Denmark,2,1,3,6,6.0,6.0
1964 Summer Olympics,16,1964,Yugoslavia,2,1,2,5,2.0,5.0
1964 Summer Olympics,16,1964,Belgium,2,0,1,3,4.0,3.0
1964 Summer Olympics,16,1964,France,1,8,6,15,5.0,15.73
1964 Summer Olympics,16,1964,Canada,1,2,1,4,1.0,4.0
1964 Summer Olympics,16,1964,Switzerland,1,2,1,4,6.0,4.0
1964 Summer Olympics,16,1964,Ethiopia,1,0,0,1,1.0,1.0
1964 Summer Olympics,16,1964,India,1,0,0,1,1.0,1.0
1964 Summer Olympics,16,1964,The Bahamas,1,0,0,1,1.0,1.0
1964 Summer Olympics,16,1964,Republic of Korea,0,2,1,3,2.0,3.06
1964 Summer Olympics,16,1964,Trinidad and Tobago,0,1,2,3,2.0,3.0
1964 Summer Olympics,16,1964,Tunisia,0,1,1,2,0.0,2.0
1964 Summer Olympics,16,1964,Argentina,0,1,0,1,2.0,1.0
1964 Summer Olympics,16,1964,Cuba,0,1,0,1,1.0,1.0
1964 Summer Olympics,16,1964,Pakistan,0,1,0,1,2.0,1.0
1964 Summer Olympics,16,1964,Philippines,0,1,0,1,1.0,1.0
1964 Summer Olympics,16,1964,Islamic Republic of Iran,0,0,2,2,4.0,2.0
1964 Summer Olympics,16,1964,Brazil,0,0,1,1,2.0,1.0
1964 Summer Olympics,16,1964,Ghana,0,0,1,1,1.0,1.0
1964 Summer Olympics,16,1964,Ireland,0,0,1,1,5.0,1.0
1964 Summer Olympics,16,1964,Kenya,0,0,1,1,0.0,1.0
1964 Summer Olympics,16,1964,Mexico,0,0,1,1,1.0,1.0
1964 Summer Olympics,16,1964,Nigeria,0,0,1,1,0.0,1.0
1964 Summer Olympics,16,1964,Uruguay,0,0,1,1,1.0,1.0
1968 Summer Olympics,17,1968,United States,45,28,34,107,90.0,104.74
1968 Summer Olympics,17,1968,Soviet Union,29,32,30,91,96.0,87.83
1968 Summer Olympics,17,1968,Japan,11,7,7,25,29.0,24.62
1968 Summer Olympics,17,1968,Hungary,10,10,12,32,22.0,33.43
1968 Summer Olympics,17,1968,East Germany,9,9,7,25,0.0,25.1
1968 Summer Olympics,17,1968,France,7,3,5,15,15.0,15.21
1968 Summer Olympics,17,1968,Czechoslovakia,7,2,4,13,14.0,11.97
1968 Summer Olympics,17,1968,West Germany,5,11,10,26,0.0,23.91
1968 Summer Olympics,17,1968,Australia,5,7,5,17,18.0,17.01
1968 Summer Olympics,17,1968,Great Britain,5,5,3,13,18.0,13.18
1968 Summer Olympics,17,1968,Poland,5,2,11,18,23.0,19.12
1968 Summer Olympics,17,1968,Romania,4,6,5,15,12.0,15.09
1968 Summer Olympics,17,1968,Italy,3,4,9,16,27.0,15.52
1968 Summer Olympics,17,1968,Kenya,3,4,2,9,1.0,8.91
1968 Summer Olympics,17,1968,Mexico,3,3,3,9,1.0,8.98
1968 Summer Olympics,17,1968,Yugoslavia,3,3,2,8,5.0,7.83
1968 Summer Olympics,17,1968,Netherlands,3,3,1,7,10.0,6.98
1968 Summer Olympics,17,1968,Bulgaria,2,4,3,9,10.0,9.16
1968 Summer Olympics,17,1968,Islamic Republic of Iran,2,1,2,5,2.0,5.0
1968 Summer Olympics,17,1968,Sweden,2,1,1,4,8.0,4.01
1968 Summer Olympics,17,1968,Türkiye,2,0,0,2,6.0,2.0
1968 Summer Olympics,17,1968,Denmark,1,4,3,8,6.0,8.09
1968 Summer Olympics,17,1968,Canada,1,3,1,5,4.0,5.02
1968 Summer Olympics,17,1968,Finland,1,2,1,4,5.0,4.0
1968 Summer Olympics,17,1968,Ethiopia,1,1,0,2,1.0,2.0
1968 Summer Olympics,17,1968,Norway,1,1,0,2,1.0,2.0
1968 Summer Olympics,17,1968,New Zealand,1,0,2,3,5.0,3.0
1968 Summer Olympics,17,1968,Tunisia,1,0,1,2,2.0,2.0
1968 Summer Olympics,17,1968,Pakistan,1,0,0,1,1.0,1.0
1968 Summer Olympics,17,1968,Venezuela,1,0,0,1,1.0,1.0
1968 Summer Olympics,17,1968,Cuba,0,4,0,4,1.0,3.83
1968 Summer Olympics,17,1968,Austria,0,2,2,4,2.0,4.06
1968 Summer Olympics,17,1968,Switzerland,0,1,4,5,4.0,5.04
1968 Summer Olympics,17,1968,Mongolia,0,1,3,4,0.0,4.03
1968 Summer Olympics,17,1968,Brazil,0,1,2,3,1.0,3.0
1968 Summer Olympics,17,1968,Belgium,0,1,1,2,3.0,2.0
1968 Summer Olympics,17,1968,Republic of Korea,0,1,1,2,3.0,2.0
1968 Summer Olympics,17,1968,Uganda,0,1,1,2,0.0,2.0
1968 Summer Olympics,17,1968,Cameroon,0,1,0,1,0.0,1.0
1968 Summer Olympics,17,1968,Jamaica,0,1,0,1,5.0,1.0
1968 Summer Olympics,17,1968,Argentina,0,0,2,2,1.0,2.0
1968 Summer Olympics,17,1968,Chinese Taipei,0,0,1,1,1.0,1.0
1968 Summer Olympics,17,1968,Greece,0,0,1,1,1.0,1.0
1968 Summer Olympics,17,1968,India,0,0,1,1,1.0,1.0
1972 Summer Olympics,18,1972,Soviet Union,50,27,22,99,91.0,97.48
1972 Summer Olympics,18,1972,United States,33,31,30,94,107.0,94.12
1972 Summer Olympics,18,1972,East Germany,20,23,23,66,25.0,65.72
1972 Summer Olympics,18,1972,West Germany,13,11,16,40,26.0,39.35
1972 Summer Olympics,18,1972,Japan,13,8,8,29,25.0,28.64
1972 Summer Olympics,18,1972,Australia,8,7,2,17,17.0,17.15
1972 Summer Olympics,18,1972,Poland,7,5,9,21,18.0,21.1
1972 Summer Olympics,18,1972,Hungary,6,13,16,35,32.0,35.55
1972 Summer Olympics,18,1972,Bulgaria,6,10,5,21,9.0,21.34
1972 Summer Olympics,18,1972,Italy,5,3,10,18,16.0,18.55
1972 Summer Olympics,18,1972,Sweden,4,6,6,16,4.0,15.69
1972 Summer Olympics,18,1972,Great Britain,4,5,9,18,13.0,18.41
1972 Summer Olympics,18,1972,Romania,3,6,7,16,15.0,15.78
1972 Summer Olympics,18,1972,Cuba,3,1,4,8,4.0,8.02
1972 Summer Olympics,18,1972,Finland,3,1,4,8,4.0,8.02
1972 Summer Olympics,18,1972,Netherlands,3,1,1,5,7.0,5.04
1972 Summer Olympics,18,1972,France,2,4,7,13,15.0,12.34
1972 Summer Olympics,18,1972,Czechoslovakia,2,4,2,8,13.0,8.09
1972 Summer Olympics,18,1972,Kenya,2,3,4,9,9.0,8.94
1972 Summer Olympics,18,1972,Yugoslavia,2,1,2,5,8.0,5.02
1972 Summer Olympics,18,1972,Norway,2,1,1,4,2.0,4.01
1972 Summer Olympics,18,1972,Democratic People's Republic of Korea,1,1,3,5,0.0,5.0
1972 Summer Olympics,18,1972,New Zealand,1,1,1,3,3.0,3.0
1972 Summer Olympics,18,1972,Uganda,1,1,0,2,2.0,2.0
1972 Summer Olympics,18,1972,Denmark,1,0,0,1,8.0,1.0
1972 Summer Olympics,18,1972,Switzerland,0,3,0,3,5.0,3.45
1972 Summer Olympics,18,1972,Canada,0,2,3,5,5.0,5.01
1972 Summer Olympics,18,1972,Islamic Republic of Iran,0,2,1,3,5.0,3.06
1972 Summer Olympics,18,1972,Belgium,0,2,0,2,2.0,2.0
1972 Summer Olympics,18,1972,Greece,0,2,0,2,1.0,2.0
1972 Summer Olympics,18,1972,Austria,0,1,2,3,4.0,3.0
1972 Summer Olympics,18,1972,Colombia,0,1,2,3,0.0,3.0
1972 Summer Olympics,18,1972,Argentina,0,1,0,1,2.0,1.0
1972 Summer Olympics,18,1972,Lebanon,0,1,0,1,2.0,1.0
1972 Summer Olympics,18,1972,Mexico,0,1,0,1,9.0,1.0
1972 Summer Olympics,18,1972,Mongolia,0,1,0,1,4.0,1.0
1972 Summer Olympics,18,1972,Pakistan,0,1,0,1,1.0,1.0
1972 Summer Olympics,18,1972,Republic of Korea,0,1,0,1,2.0,1.0
1972 Summer Olympics,18,1972,Tunisia,0,1,0,1,2.0,1.0
1972 Summer Olympics,18,1972,Türkiye,0,1,0,1,2.0,1.0
1972 Summer Olympics,18,1972,Brazil,0,0,2,2,3.0,2.0
1972 Summer Olympics,18,1972,Ethiopia,0,0,2,2,2.0,2.0
1972 Summer Olympics,18,1972,Ghana,0,0,1,1,1.0,1.0
1972 Summer Olympics,18,1972,India,0,0,1,1,1.0,1.0
1972 Summer Olympics,18,1972,Jamaica,0,0,1,1,1.0,1.0
1972 Summer Olympics,18,1972,Niger,0,0,1,1,0.0,1.0
1972 Summer Olympics,18,1972,Nigeria,0,0,1,1,1.0,1.0
1972 Summer Olympics,18,1972,Spain,0,0,1,1,1.0,1.0
1976 Summer Olympics,19,1976,Soviet Union,49,41,35,125,99.0,111.9
1976 Summer Olympics,19,1976,East Germany,40,25,25,90,66.0,91.66
1976 Summer Olympics,19,1976,United States,34,35,25,94,94.0,92.61
1976 Summer Olympics,19,1976,West Germany,10,12,17,39,40.0,38.85
1976 Summer Olympics,19,1976,Japan,9,6,10,25,29.0,24.74
1976 Summer Olympics,19,1976,Poland,7,6,13,26,21.0,25.97
1976 Summer Olympics,19,1976,Bulgaria,6,9,7,22,21.0,22.55
1976 Summer Olympics,19,1976,Cuba,6,4,3,13,8.0,12.63
1976 Summer Olympics,19,1976,Romania,4,9,14,27,16.0,30.3
1976 Summer Olympics,19,1976,Hungary,4,5,13,22,35.0,22.9
1976 Summer Olympics,19,1976,Finland,4,2,0,6,8.0,6.11
1976 Summer Olympics,19,1976,Sweden,4,1,0,5,16.0,5.04
1976 Summer Olympics,19,1976,Great Britain,3,5,5,13,18.0,13.09
1976 Summer Olympics,19,1976,Italy,2,7,4,13,18.0,12.8
1976 Summer Olympics,19,1976,France,2,3,4,9,13.0,8.91
1976 Summer Olympics,19,1976,Yugoslavia,2,3,3,8,5.0,8.03
1976 Summer Olympics,19,1976,Czechoslovakia,2,2,4,8,8.0,8.08
1976 Summer Olympics,19,1976,New Zealand,2,1,1,4,3.0,4.01
1976 Summer Olympics,19,1976,Republic of Korea,1,1,4,6,1.0,5.98
1976 Summer Olympics,19,1976,Switzerland,1,1,2,4,3.0,4.0
1976 Summer Olympics,19,1976,Democratic People's Republic of Korea,1,1,0,2,5.0,2.0
1976 Summer Olympics,19,1976,Jamaica,1,1,0,2,1.0,2.0
1976 Summer Olympics,19,1976,Norway,1,1,0,2,4.0,2.0
1976 Summer Olympics,19,1976,Denmark,1,0,2,3,1.0,3.0
1976 Summer Olympics,19,1976,Mexico,1,0,1,2,1.0,2.0
1976 Summer Olympics,19,1976,Trinidad and Tobago,1,0,0,1,3.0,1.0
1976 Summer Olympics,19,1976,Canada,0,5,6,11,5.0,13.15
1976 Summer Olympics,19,1976,Belgium,0,3,3,6,2.0,6.06
1976 Summer Olympics,19,1976,Netherlands,0,2,3,5,5.0,5.01
1976 Summer Olympics,19,1976,Portugal,0,2,0,2,1.0,2.0
1976 Summer Olympics,19,1976,Spain,0,2,0,2,1.0,2.0
1976 Summer Olympics,19,1976,Australia,0,1,4,5,17.0,4.98
1976 Summer Olympics,19,1976,Islamic Republic of Iran,0,1,1,2,3.0,2.0
1976 Summer Olympics,19,1976,Mongolia,0,1,0,1,1.0,1.0
1976 Summer Olympics,19,1976,Venezuela,0,1,0,1,1.0,1.0
1976 Summer Olympics,19,1976,Brazil,0,0,2,2,2.0,2.0
1976 Summer Olympics,19,1976,Austria,0,0,1,1,3.0,1.0
1976 Summer Olympics,19,1976,Bermuda,0,0,1,1,0.0,1.0
1976 Summer Olympics,19,1976,Pakistan,0,0,1,1,1.0,1.0
1976 Summer Olympics,19,1976,Puerto Rico,0,0,1,1,1.0,1.0
1976 Summer Olympics,19,1976,Thailand,0,0,1,1,0.0,1.0
1980 Summer Olympics,20,1980,Soviet Union,80,69,46,195,125.0,180.34
1980 Summer Olympics,20,1980,East Germany,47,37,42,126,90.0,121.83
1980 Summer Olympics,20,1980,Bulgaria,8,16,17,41,22.0,42.46
1980 Summer Olympics,20,1980,Cuba,8,7,5,20,13.0,19.81
1980 Summer Olympics,20,1980,Italy,8,3,4,15,13.0,14.94
1980 Summer Olympics,20,1980,Hungary,7,10,15,32,22.0,32.5
1980 Summer Olympics,20,1980,Romania,6,6,13,25,27.0,25.3
1980 Summer Olympics,20,1980,France,6,5,3,14,9.0,13.65
1980 Summer Olympics,20,1980,Great Britain,5,7,9,21,13.0,19.79
1980 Summer Olympics,20,1980,Poland,3,14,15,32,26.0,32.92
1980 Summer Olympics,20,1980,Sweden,3,3,6,12,5.0,12.01
1980 Summer Olympics,20,1980,Finland,3,1,4,8,6.0,8.28
1980 Summer Olympics,20,1980,Czechoslovakia,2,3,9,14,8.0,13.83
1980 Summer Olympics,20,1980,Yugoslavia,2,3,4,9,8.0,8.95
1980 Summer Olympics,20,1980,Australia,2,2,5,9,5.0,8.98
1980 Summer Olympics,20,1980,Denmark,2,1,2,5,3.0,5.03
1980 Summer Olympics,20,1980,Brazil,2,0,2,4,2.0,4.37
1980 Summer Olympics,20,1980,Ethiopia,2,0,2,4,2.0,4.37
1980 Summer Olympics,20,1980,Switzerland,2,0,0,2,4.0,2.0
1980 Summer Olympics,20,1980,Spain,1,3,2,6,2.0,5.99
1980 Summer Olympics,20,1980,Austria,1,2,1,4,1.0,4.0
1980 Summer Olympics,20,1980,Greece,1,0,2,3,2.0,3.0
1980 Summer Olympics,20,1980,Belgium,1,0,0,1,6.0,1.0
1980 Summer Olympics,20,1980,India,1,0,0,1,1.0,1.0
1980 Summer Olympics,20,1980,Zimbabwe,1,0,0,1,0.0,1.0
1980 Summer Olympics,20,1980,Democratic People's Republic of Korea,0,3,2,5,2.0,5.03
1980 Summer Olympics,20,1980,Mongolia,0,2,2,4,1.0,4.05
1980 Summer Olympics,20,1980,United Republic of Tanzania,0,2,0,2,0.0,2.0
1980 Summer Olympics,20,1980,Mexico,0,1,3,4,2.0,4.06
1980 Summer Olympics,20,1980,Netherlands,0,1,2,3,5.0,3.0
1980 Summer Olympics,20,1980,Ireland,0,1,1,2,1.0,2.0
1980 Summer Olympics,20,1980,Uganda,0,1,0,1,2.0,1.0
1980 Summer Olympics,20,1980,Venezuela,0,1,0,1,1.0,1.0
1980 Summer Olympics,20,1980,Jamaica,0,0,3,3,2.0,3.0
1980 Summer Olympics,20,1980,Guyana,0,0,1,1,0.0,1.0
1980 Summer Olympics,20,1980,Lebanon,0,0,1,1,1.0,1.0
1984 Summer Olympics,21,1984,United States,83,61,30,174,94.0,167.77
1984 Summer Olympics,21,1984,Romania,20,16,17,53,25.0,55.0
1984 Summer Olympics,21,1984,West Germany,17,19,23,59,39.0,59.27
1984 Summer Olympics,21,1984,People's Republic of China,15,8,9,32,0.0,30.08
1984 Summer Olympics,21,1984,Italy,14,6,12,32,15.0,30.99
1984 Summer Olympics,21,1984,Canada,10,18,16,44,11.0,44.35
1984 Summer Olympics,21,1984,Japan,10,8,14,32,25.0,31.37
1984 Summer Olympics,21,1984,New Zealand,8,1,2,11,4.0,10.14
1984 Summer Olympics,21,1984,Yugoslavia,7,4,7,18,9.0,17.4
1984 Summer Olympics,21,1984,Republic of Korea,6,6,7,19,6.0,19.11
1984 Summer Olympics,21,1984,Great Britain,5,11,21,37,21.0,36.06
1984 Summer Olympics,21,1984,France,5,7,16,28,14.0,27.16
1984 Summer Olympics,21,1984,Netherlands,5,2,6,13,3.0,12.15
1984 Summer Olympics,21,1984,Australia,4,8,12,24,9.0,24.45
1984 Summer Olympics,21,1984,Finland,4,2,6,12,8.0,11.58
1984 Summer Olympics,21,1984,Sweden,2,11,6,19,12.0,20.12
1984 Summer Olympics,21,1984,Mexico,2,3,1,6,4.0,5.98
1984 Summer Olympics,21,1984,Morocco,2,0,0,2,1.0,2.0
1984 Summer Olympics,21,1984,Brazil,1,5,2,8,4.0,8.25
1984 Summer Olympics,21,1984,Spain,1,2,2,5,6.0,5.01
1984 Summer Olympics,21,1984,Belgium,1,1,2,4,1.0,4.0
1984 Summer Olympics,21,1984,Austria,1,1,1,3,4.0,3.0
1984 Summer Olympics,21,1984,Kenya,1,0,2,3,9.0,3.04
1984 Summer Olympics,21,1984,Portugal,1,0,2,3,2.0,3.0
1984 Summer Olympics,21,1984,Pakistan,1,0,0,1,1.0,1.0
1984 Summer Olympics,21,1984,Switzerland,0,4,4,8,2.0,8.1
1984 Summer Olympics,21,1984,Denmark,0,3,3,6,5.0,5.94
1984 Summer Olympics,21,1984,Jamaica,0,1,2,3,3.0,3.0
1984 Summer Olympics,21,1984,Norway,0,1,2,3,2.0,3.0
1984 Summer Olympics,21,1984,Greece,0,1,1,2,3.0,2.0
1984 Summer Olympics,21,1984,Nigeria,0,1,1,2,1.0,2.0
1984 Summer Olympics,21,1984,Puerto Rico,0,1,1,2,1.0,2.0
1984 Summer Olympics,21,1984,Colombia,0,1,0,1,3.0,1.0
1984 Summer Olympics,21,1984,Côte d'Ivoire,0,1,0,1,0.0,1.0
1984 Summer Olympics,21,1984,Egypt,0,1,0,1,1.0,1.0
1984 Summer Olympics,21,1984,Ireland,0,1,0,1,2.0,1.0
1984 Summer Olympics,21,1984,Peru,0,1,0,1,1.0,1.0
1984 Summer Olympics,21,1984,Syrian Arab Republic,0,1,0,1,0.0,1.0
1984 Summer Olympics,21,1984,Thailand,0,1,0,1,1.0,1.0
1984 Summer Olympics,21,1984,Türkiye,0,0,3,3,1.0,3.0
1984 Summer Olympics,21,1984,Venezuela,0,0,3,3,1.0,3.0
1984 Summer Olympics,21,1984,Algeria,0,0,2,2,0.0,2.0
1984 Summer Olympics,21,1984,Cameroon,0,0,1,1,1.0,1.0
1984 Summer Olympics,21,1984,Chinese Taipei,0,0,1,1,1.0,1.0
1984 Summer Olympics,21,1984,Dominican Republic,0,0,1,1,0.0,1.0
1984 Summer Olympics,21,1984,Iceland,0,0,1,1,1.0,1.0
1984 Summer Olympics,21,1984,Zambia,0,0,1,1,0.0,1.0
1988 Summer Olympics,22,1988,Soviet Union,55,31,46,132,195.0,133.0
1988 Summer Olympics,22,1988,East Germany,37,35,30,102,126.0,101.38
1988 Summer Olympics,22,1988,United States,36,31,27,94,174.0,97.08
1988 Summer Olympics,22,1988,Republic of Korea,12,10,11,33,19.0,33.25
1988 Summer Olympics,22,1988,West Germany,11,14,15,40,59.0,39.24
1988 Summer Olympics,22,1988,Hungary,11,6,6,23,32.0,23.51
1988 Summer Olympics,22,1988,Bulgaria,10,12,13,35,41.0,34.86
1988 Summer Olympics,22,1988,Romania,7,11,6,24,53.0,24.18
1988 Summer Olympics,22,1988,France,6,4,6,16,28.0,15.5
1988 Summer Olympics,22,1988,Italy,6,4,4,14,32.0,13.49
1988 Summer Olympics,22,1988,People's Republic of China,5,11,12,28,32.0,29.36
1988 Summer Olympics,22,1988,Great Britain,5,10,9,24,37.0,23.69
1988 Summer Olympics,22,1988,Kenya,5,2,2,9,3.0,9.63
1988 Summer Olympics,22,1988,Japan,4,3,7,14,32.0,14.02
1988 Summer Olympics,22,1988,Australia,3,6,5,14,24.0,14.29
1988 Summer Olympics,22,1988,Yugoslavia,3,4,5,12,18.0,12.06
1988 Summer Olympics,22,1988,Czechoslovakia,3,3,2,8,14.0,7.98
1988 Summer Olympics,22,1988,New Zealand,3,2,8,13,11.0,12.81
1988 Summer Olympics,22,1988,Canada,3,2,5,10,44.0,10.22
1988 Summer Olympics,22,1988,Poland,2,5,9,16,32.0,16.85
1988 Summer Olympics,22,1988,Norway,2,3,0,5,3.0,5.13
1988 Summer Olympics,22,1988,Netherlands,2,2,5,9,13.0,9.04
1988 Summer Olympics,22,1988,Denmark,2,1,1,4,6.0,4.0
1988 Summer Olympics,22,1988,Brazil,1,2,3,6,8.0,6.03
1988 Summer Olympics,22,1988,Finland,1,1,2,4,12.0,4.0
1988 Summer Olympics,22,1988,Spain,1,1,2,4,5.0,4.0
1988 Summer Olympics,22,1988,Türkiye,1,1,0,2,3.0,2.0
1988 Summer Olympics,22,1988,Morocco,1,0,2,3,2.0,3.0
1988 Summer Olympics,22,1988,Austria,1,0,0,1,3.0,1.0
1988 Summer Olympics,22,1988,Portugal,1,0,0,1,3.0,1.0
1988 Summer Olympics,22,1988,Suriname,1,0,0,1,0.0,1.0
1988 Summer Olympics,22,1988,Sweden,0,4,7,11,19.0,11.03
1988 Summer Olympics,22,1988,Switzerland,0,2,2,4,8.0,4.07
1988 Summer Olympics,22,1988,Jamaica,0,2,0,2,3.0,2.0
1988 Summer Olympics,22,1988,Argentina,0,1,1,2,1.0,2.0
1988 Summer Olympics,22,1988,Chile,0,1,0,1,4.0,1.0
1988 Summer Olympics,22,1988,Costa Rica,0,1,0,1,0.0,1.0
1988 Summer Olympics,22,1988,Indonesia,0,1,0,1,0.0,1.0
1988 Summer Olympics,22,1988,Islamic Republic of Iran,0,1,0,1,2.0,1.0
1988 Summer Olympics,22,1988,Netherlands Antilles,0,1,0,1,0.0,1.0
1988 Summer Olympics,22,1988,Peru,0,1,0,1,1.0,1.0
1988 Summer Olympics,22,1988,Senegal,0,1,0,1,0.0,1.0
1988 Summer Olympics,22,1988,United States Virgin Islands,0,1,0,1,0.0,1.0
1988 Summer Olympics,22,1988,Belgium,0,0,2,2,4.0,2.0
1988 Summer Olympics,22,1988,Mexico,0,0,2,2,6.0,2.0
1988 Summer Olympics,22,1988,Colombia,0,0,1,1,1.0,1.0
1988 Summer Olympics,22,1988,Djibouti,0,0,1,1,0.0,1.0
1988 Summer Olympics,22,1988,Greece,0,0,1,1,2.0,1.0
1988 Summer Olympics,22,1988,Mongolia,0,0,1,1,4.0,1.0
1988 Summer Olympics,22,1988,Pakistan,0,0,1,1,1.0,1.0
1988 Summer Olympics,22,1988,Philippines,0,0,1,1,1.0,1.0
1988 Summer Olympics,22,1988,Thailand,0,0,1,1,1.0,1.0
1992 Summer Olympics,23,1992,Unified Team,45,38,29,112,0.0,101.54
1992 Summer Olympics,23,1992,United States,37,34,37,108,94.0,108.83
1992 Summer Olympics,23,1992,Germany,33,21,28,82,50.0,82.11
1992 Summer Olympics,23,1992,People's Republic of China,16,22,16,54,28.0,53.57
1992 Summer Olympics,23,1992,Cuba,14,6,11,31,20.0,30.78
1992 Summer Olympics,23,1992,Spain,13,7,2,22,4.0,21.36
1992 Summer Olympics,23,1992,Republic of Korea,12,5,12,29,33.0,28.15
1992 Summer Olympics,23,1992,Hungary,11,12,7,30,23.0,28.04
1992 Summer Olympics,23,1992,France,8,5,16,29,16.0,27.69
1992 Summer Olympics,23,1992,Australia,7,9,11,27,14.0,27.42
1992 Summer Olympics,23,1992,Canada,7,4,7,18,10.0,17.45
1992 Summer Olympics,23,1992,Italy,6,5,8,19,14.0,19.25
1992 Summer Olympics,23,1992,Great Britain,5,3,12,20,24.0,20.87
1992 Summer Olympics,23,1992,Romania,4,6,8,18,24.0,16.95
1992 Summer Olympics,23,1992,Czechoslovakia,4,2,1,7,8.0,6.88
1992 Summer Olympics,23,1992,Democratic People's Republic of Korea,4,0,5,9,5.0,9.54
1992 Summer Olympics,23,1992,Japan,3,8,11,22,14.0,22.39
1992 Summer Olympics,23,1992,Bulgaria,3,7,6,16,35.0,15.54
1992 Summer Olympics,23,1992,Poland,3,6,10,19,16.0,18.61
1992 Summer Olympics,23,1992,Netherlands,2,6,7,15,9.0,15.41
1992 Summer Olympics,23,1992,Kenya,2,4,2,8,9.0,8.01
1992 Summer Olympics,23,1992,Norway,2,4,1,7,5.0,6.99
1992 Summer Olympics,23,1992,Türkiye,2,2,2,6,2.0,6.05
1992 Summer Olympics,23,1992,Indonesia,2,2,1,5,1.0,4.99
1992 Summer Olympics,23,1992,Brazil,2,1,0,3,6.0,3.03
1992 Summer Olympics,23,1992,Greece,2,0,0,2,1.0,2.0
1992 Summer Olympics,23,1992,Sweden,1,7,4,12,11.0,11.87
1992 Summer Olympics,23,1992,New Zealand,1,4,5,10,13.0,10.22
1992 Summer Olympics,23,1992,Finland,1,2,2,5,4.0,5.01
1992 Summer Olympics,23,1992,Denmark,1,1,4,6,4.0,5.97
1992 Summer Olympics,23,1992,Morocco,1,1,1,3,3.0,3.0
1992 Summer Olympics,23,1992,Ireland,1,1,0,2,1.0,2.0
1992 Summer Olympics,23,1992,Ethiopia,1,0,2,3,4.0,3.0
1992 Summer Olympics,23,1992,Algeria,1,0,1,2,2.0,2.0
1992 Summer Olympics,23,1992,Estonia,1,0,1,2,7.0,2.0
1992 Summer Olympics,23,1992,Lithuania,1,0,1,2,0.0,2.0
1992 Summer Olympics,23,1992,Switzerland,1,0,0,1,4.0,1.0
1992 Summer Olympics,23,1992,Jamaica,0,3,1,4,2.0,4.03
1992 Summer Olympics,23,1992,Nigeria,0,3,1,4,2.0,4.03
1992 Summer Olympics,23,1992,Latvia,0,2,1,3,2.0,3.06
1992 Summer Olympics,23,1992,Austria,0,2,0,2,1.0,2.0
1992 Summer Olympics,23,1992,Namibia,0,2,0,2,0.0,2.0
1992 Summer Olympics,23,1992,South Africa,0,2,0,2,3.0,2.0
1992 Summer Olympics,23,1992,Belgium,0,1,2,3,2.0,3.0
1992 Summer Olympics,23,1992,Croatia,0,1,2,3,0.0,3.0
1992 Summer Olympics,23,1992,Independent Olympic Athletes,0,1,2,3,0.0,3.0
1992 Summer Olympics,23,1992,Islamic Republic of Iran,0,1,2,3,1.0,3.0
1992 Summer Olympics,23,1992,Israel,0,1,1,2,0.0,2.0
1992 Summer Olympics,23,1992,Chinese Taipei,0,1,0,1,1.0,1.0
1992 Summer Olympics,23,1992,Mexico,0,1,0,1,2.0,1.0
1992 Summer Olympics,23,1992,Peru,0,1,0,1,1.0,1.0
1992 Summer Olympics,23,1992,Mongolia,0,0,2,2,1.0,2.0
1992 Summer Olympics,23,1992,Slovenia,0,0,2,2,0.0,2.0
1992 Summer Olympics,23,1992,Argentina,0,0,1,1,2.0,1.0
1992 Summer Olympics,23,1992,Colombia,0,0,1,1,1.0,1.0
1992 Summer Olympics,23,1992,Ghana,0,0,1,1,1.0,1.0
1992 Summer Olympics,23,1992,Malaysia,0,0,1,1,0.0,1.0
1992 Summer Olympics,23,1992,Pakistan,0,0,1,1,1.0,1.0
1992 Summer Olympics,23,1992,Philippines,0,0,1,1,1.0,1.0
1992 Summer Olympics,23,1992,Puerto Rico,0,0,1,1,2.0,1.0
1992 Summer Olympics,23,1992,Qatar,0,0,1,1,0.0,1.0
1992 Summer Olympics,23,1992,Suriname,0,0,1,1,1.0,1.0
1992 Summer Olympics,23,1992,Thailand,0,0,1,1,1.0,1.0
1992 Summer Olympics,23,1992,The Bahamas,0,0,1,1,1.0,1.0
1996 Summer Olympics,24,1996,United States,44,32,25,101,108.0,100.69
1996 Summer Olympics,24,1996,Russian Federation,26,21,16,63,5.0,61.65
1996 Summer Olympics,24,1996,Germany,20,18,27,65,82.0,65.43
1996 Summer Olympics,24,1996,People's Republic of China,16,22,12,50,54.0,51.41
1996 Summer Olympics,24,1996,France,15,7,15,37,29.0,35.55
1996 Summer Olympics,24,1996,Italy,13,10,12,35,19.0,34.72
1996 Summer Olympics,24,1996,Australia,9,9,23,41,27.0,38.74
1996 Summer Olympics,24,1996,Cuba,9,8,8,25,31.0,25.22
1996 Summer Olympics,24,1996,Ukraine,9,2,12,23,0.0,22.61
1996 Summer Olympics,24,1996,Republic of Korea,7,15,5,27,29.0,25.12
1996 Summer Olympics,24,1996,Poland,7,5,5,17,19.0,17.18
1996 Summer Olympics,24,1996,Hungary,7,4,10,21,30.0,20.69
1996 Summer Olympics,24,1996,Spain,5,6,6,17,22.0,16.95
1996 Summer Olympics,24,1996,Romania,4,7,9,20,18.0,18.66
1996 Summer Olympics,24,1996,Netherlands,4,5,10,19,15.0,18.97
1996 Summer Olympics,24,1996,Greece,4,4,0,8,2.0,7.9
1996 Summer Olympics,24,1996,Czechia,4,3,4,11,0.0,10.16
1996 Summer Olympics,24,1996,Switzerland,4,3,0,7,1.0,7.04
1996 Summer Olympics,24,1996,Denmark,4,1,1,6,6.0,5.96
1996 Summer Olympics,24,1996,Türkiye,4,1,1,6,6.0,5.96
1996 Summer Olympics,24,1996,Canada,3,11,8,22,18.0,21.69
1996 Summer Olympics,24,1996,Bulgaria,3,7,5,15,16.0,15.19
1996 Summer Olympics,24,1996,Japan,3,6,5,14,22.0,14.51
1996 Summer Olympics,24,1996,Kazakhstan,3,4,4,11,0.0,9.87
1996 Summer Olympics,24,1996,Brazil,3,3,9,15,3.0,14.96
1996 Summer Olympics,24,1996,New Zealand,3,2,1,6,10.0,6.12
1996 Summer Olympics,24,1996,South Africa,3,1,1,5,2.0,5.03
1996 Summer Olympics,24,1996,Ireland,3,0,1,4,2.0,4.16
1996 Summer Olympics,24,1996,Sweden,2,4,2,8,12.0,8.02
1996 Summer Olympics,24,1996,Norway,2,2,3,7,7.0,6.96
1996 Summer Olympics,24,1996,Belgium,2,2,2,6,3.0,6.04
1996 Summer Olympics,24,1996,Nigeria,2,1,3,6,4.0,6.01
1996 Summer Olympics,24,1996,Democratic People's Republic of Korea,2,1,2,5,9.0,5.03
1996 Summer Olympics,24,1996,Algeria,2,0,1,3,2.0,3.0
1996 Summer Olympics,24,1996,Ethiopia,2,0,1,3,3.0,3.0
1996 Summer Olympics,24,1996,Great Britain,1,8,6,15,20.0,15.52
1996 Summer Olympics,24,1996,Belarus,1,6,8,15,0.0,15.53
1996 Summer Olympics,24,1996,Kenya,1,4,3,8,8.0,8.03
1996 Summer Olympics,24,1996,Jamaica,1,3,2,6,4.0,6.01
1996 Summer Olympics,24,1996,Finland,1,2,1,4,5.0,4.0
1996 Summer Olympics,24,1996,Indonesia,1,1,2,4,5.0,4.0
1996 Summer Olympics,24,1996,Serbia and Montenegro,1,1,2,4,0.0,4.0
1996 Summer Olympics,24,1996,Islamic Republic of Iran,1,1,1,3,3.0,3.0
1996 Summer Olympics,24,1996,Slovakia,1,1,1,3,0.0,3.0
1996 Summer Olympics,24,1996,Armenia,1,1,0,2,0.0,2.0
1996 Summer Olympics,24,1996,Croatia,1,1,0,2,3.0,2.0
1996 Summer Olympics,24,1996,Portugal,1,0,1,2,1.0,2.0
1996 Summer Olympics,24,1996,Thailand,1,0,1,2,1.0,2.0
1996 Summer Olympics,24,1996,Burundi,1,0,0,1,0.0,1.0
1996 Summer Olympics,24,1996,Costa Rica,1,0,0,1,1.0,1.0
1996 Summer Olympics,24,1996,Ecuador,1,0,0,1,0.0,1.0
1996 Summer Olympics,24,1996,"Hong Kong, China",1,0,0,1,0.0,1.0
1996 Summer Olympics,24,1996,Syrian Arab Republic,1,0,0,1,1.0,1.0
1996 Summer Olympics,24,1996,Argentina,0,2,1,3,1.0,3.04
1996 Summer Olympics,24,1996,Namibia,0,2,0,2,2.0,2.0
1996 Summer Olympics,24,1996,Slovenia,0,2,0,2,2.0,2.0
1996 Summer Olympics,24,1996,Austria,0,1,2,3,2.0,3.0
1996 Summer Olympics,24,1996,Malaysia,0,1,1,2,1.0,2.0
1996 Summer Olympics,24,1996,Republic of Moldova,0,1,1,2,0.0,2.0
1996 Summer Olympics,24,1996,Uzbekistan,0,1,1,2,0.0,2.0
1996 Summer Olympics,24,1996,Azerbaijan,0,1,0,1,0.0,1.0
1996 Summer Olympics,24,1996,Chinese Taipei,0,1,0,1,1.0,1.0
1996 Summer Olympics,24,1996,Latvia,0,1,0,1,3.0,1.0
1996 Summer Olympics,24,1996,Philippines,0,1,0,1,1.0,1.0
1996 Summer Olympics,24,1996,The Bahamas,0,1,0,1,1.0,1.0
1996 Summer Olympics,24,1996,Tonga,0,1,0,1,0.0,1.0
1996 Summer Olympics,24,1996,Zambia,0,1,0,1,1.0,1.0
1996 Summer Olympics,24,1996,Georgia,0,0,2,2,0.0,2.0
1996 Summer Olympics,24,1996,Morocco,0,0,2,2,3.0,2.0
1996 Summer Olympics,24,1996,Trinidad and Tobago,0,0,2,2,1.0,2.0
1996 Summer Olympics,24,1996,India,0,0,1,1,1.0,1.0
1996 Summer Olympics,24,1996,Israel,0,0,1,1,2.0,1.0
1996 Summer Olympics,24,1996,Lithuania,0,0,1,1,2.0,1.0
1996 Summer Olympics,24,1996,Mexico,0,0,1,1,1.0,1.0
1996 Summer Olympics,24,1996,Mongolia,0,0,1,1,2.0,1.0
1996 Summer Olympics,24,1996,Mozambique,0,0,1,1,0.0,1.0
1996 Summer Olympics,24,1996,Puerto Rico,0,0,1,1,1.0,1.0
1996 Summer Olympics,24,1996,Tunisia,0,0,1,1,1.0,1.0
1996 Summer Olympics,24,1996,Uganda,0,0,1,1,1.0,1.0
2000 Summer Olympics,25,2000,United States,37,24,32,93,101.0,94.17
2000 Summer Olympics,25,2000,Russian Federation,32,28,29,89,63.0,86.48
2000 Summer Olympics,25,2000,People's Republic of China,28,16,14,58,50.0,58.87
2000 Summer Olympics,25,2000,Australia,16,25,17,58,41.0,57.38
2000 Summer Olympics,25,2000,Germany,13,17,26,56,65.0,49.02
2000 Summer Olympics,25,2000,France,13,14,11,38,37.0,37.51
2000 Summer Olympics,25,2000,Italy,13,8,13,34,35.0,33.5
2000 Summer Olympics,25,2000,Netherlands,12,9,4,25,19.0,24.21
2000 Summer Olympics,25,2000,Cuba,11,11,7,29,25.0,28.01
2000 Summer Olympics,25,2000,Great Britain,11,10,7,28,15.0,27.57
2000 Summer Olympics,25,2000,Romania,11,6,9,26,20.0,25.84
2000 Summer Olympics,25,2000,Republic of Korea,8,10,10,28,27.0,27.66
2000 Summer Olympics,25,2000,Hungary,8,6,3,17,21.0,17.22
2000 Summer Olympics,25,2000,Poland,6,5,3,14,17.0,13.71
2000 Summer Olympics,25,2000,Japan,5,8,5,18,14.0,17.94
2000 Summer Olympics,25,2000,Bulgaria,5,6,2,13,15.0,13.27
2000 Summer Olympics,25,2000,Greece,4,6,3,13,8.0,12.85
2000 Summer Olympics,25,2000,Sweden,4,5,3,12,8.0,11.97
2000 Summer Olympics,25,2000,Norway,4,3,3,10,7.0,10.11
2000 Summer Olympics,25,2000,Ethiopia,4,1,3,8,3.0,7.81
2000 Summer Olympics,25,2000,Ukraine,3,10,10,23,23.0,22.4
2000 Summer Olympics,25,2000,Kazakhstan,3,4,0,7,11.0,7.21
2000 Summer Olympics,25,2000,Belarus,3,3,11,17,15.0,18.15
2000 Summer Olympics,25,2000,Canada,3,3,8,14,22.0,13.97
2000 Summer Olympics,25,2000,Spain,3,3,5,11,17.0,11.26
2000 Summer Olympics,25,2000,Türkiye,3,0,2,5,6.0,5.19
2000 Summer Olympics,25,2000,Islamic Republic of Iran,3,0,1,4,3.0,4.13
2000 Summer Olympics,25,2000,Czechia,2,3,3,8,11.0,8.3
2000 Summer Olympics,25,2000,Kenya,2,3,2,7,8.0,7.0
2000 Summer Olympics,25,2000,Denmark,2,3,1,6,6.0,5.96
2000 Summer Olympics,25,2000,Finland,2,1,1,4,4.0,4.0
2000 Summer Olympics,25,2000,Austria,2,1,0,3,3.0,3.02
2000 Summer Olympics,25,2000,Lithuania,2,0,3,5,1.0,5.2
2000 Summer Olympics,25,2000,Azerbaijan,2,0,1,3,1.0,3.0
2000 Summer Olympics,25,2000,The Bahamas,2,0,1,3,1.0,3.0
2000 Summer Olympics,25,2000,Slovenia,2,0,0,2,2.0,2.0
2000 Summer Olympics,25,2000,Switzerland,1,6,2,9,7.0,9.15
2000 Summer Olympics,25,2000,Indonesia,1,3,2,6,4.0,6.0
2000 Summer Olympics,25,2000,Slovakia,1,3,1,5,3.0,4.95
2000 Summer Olympics,25,2000,Mexico,1,2,3,6,1.0,6.01
2000 Summer Olympics,25,2000,Nigeria,1,2,0,3,6.0,3.01
2000 Summer Olympics,25,2000,Algeria,1,1,3,5,3.0,5.0
2000 Summer Olympics,25,2000,Uzbekistan,1,1,2,4,2.0,4.0
2000 Summer Olympics,25,2000,Latvia,1,1,1,3,1.0,3.0
2000 Summer Olympics,25,2000,Serbia and Montenegro,1,1,1,3,4.0,3.0
2000 Summer Olympics,25,2000,New Zealand,1,0,3,4,6.0,3.97
2000 Summer Olympics,25,2000,Estonia,1,0,2,3,2.0,3.0
2000 Summer Olympics,25,2000,Thailand,1,0,2,3,2.0,3.0
2000 Summer Olympics,25,2000,Croatia,1,0,1,2,2.0,2.0
2000 Summer Olympics,25,2000,Cameroon,1,0,0,1,1.0,1.0
2000 Summer Olympics,25,2000,Colombia,1,0,0,1,1.0,1.0
2000 Summer Olympics,25,2000,Mozambique,1,0,0,1,1.0,1.0
2000 Summer Olympics,25,2000,Brazil,0,6,6,12,15.0,14.79
2000 Summer Olympics,25,2000,Jamaica,0,6,3,9,6.0,9.28
2000 Summer Olympics,25,2000,Belgium,0,2,3,5,6.0,5.0
2000 Summer Olympics,25,2000,South Africa,0,2,3,5,5.0,5.0
2000 Summer Olympics,25,2000,Argentina,0,2,2,4,3.0,4.04
2000 Summer Olympics,25,2000,Chinese Taipei,0,1,4,5,1.0,5.02
2000 Summer Olympics,25,2000,Morocco,0,1,4,5,2.0,5.05
2000 Summer Olympics,25,2000,Democratic People's Republic of Korea,0,1,3,4,5.0,4.03
2000 Summer Olympics,25,2000,Kingdom of Saudi Arabia,0,1,1,2,0.0,2.0
2000 Summer Olympics,25,2000,Republic of Moldova,0,1,1,2,2.0,2.0
2000 Summer Olympics,25,2000,Trinidad and Tobago,0,1,1,2,2.0,2.0
2000 Summer Olympics,25,2000,Ireland,0,1,0,1,4.0,1.0
2000 Summer Olympics,25,2000,Sri Lanka,0,1,0,1,1.0,1.0
2000 Summer Olympics,25,2000,Uruguay,0,1,0,1,1.0,1.0
2000 Summer Olympics,25,2000,Vietnam,0,1,0,1,0.0,1.0
2000 Summer Olympics,25,2000,Georgia,0,0,6,6,2.0,7.6
2000 Summer Olympics,25,2000,Costa Rica,0,0,2,2,1.0,2.0
2000 Summer Olympics,25,2000,Portugal,0,0,2,2,2.0,2.0
2000 Summer Olympics,25,2000,Armenia,0,0,1,1,2.0,1.0
2000 Summer Olympics,25,2000,Barbados,0,0,1,1,0.0,1.0
2000 Summer Olympics,25,2000,Chile,0,0,1,1,1.0,1.0
2000 Summer Olympics,25,2000,Iceland,0,0,1,1,1.0,1.0
2000 Summer Olympics,25,2000,India,0,0,1,1,1.0,1.0
2000 Summer Olympics,25,2000,Israel,0,0,1,1,1.0,1.0
2000 Summer Olympics,25,2000,Kuwait,0,0,1,1,0.0,1.0
2000 Summer Olympics,25,2000,Kyrgyzstan,0,0,1,1,0.0,1.0
2000 Summer Olympics,25,2000,North Macedonia,0,0,1,1,0.0,1.0
2000 Summer Olympics,25,2000,Qatar,0,0,1,1,1.0,1.0
2004 Summer Olympics,26,2004,United States,36,39,26,101,93.0,100.24
2004 Summer Olympics,26,2004,People's Republic of China,32,17,14,63,58.0,67.61
2004 Summer Olympics,26,2004,Russian Federation,28,26,36,90,89.0,87.27
2004 Summer Olympics,26,2004,Australia,17,16,17,50,58.0,51.59
2004 Summer Olympics,26,2004,Japan,16,9,12,37,18.0,37.79
2004 Summer Olympics,26,2004,Germany,13,16,20,49,56.0,47.84
2004 Summer Olympics,26,2004,France,11,9,13,33,38.0,33.13
2004 Summer Olympics,26,2004,Italy,10,11,11,32,34.0,32.51
2004 Summer Olympics,26,2004,Republic of Korea,9,12,9,30,28.0,28.28
2004 Summer Olympics,26,2004,Great Britain,9,9,12,30,28.0,30.18
2004 Summer Olympics,26,2004,Cuba,9,7,11,27,29.0,27.09
2004 Summer Olympics,26,2004,Hungary,8,6,3,17,17.0,16.98
2004 Summer Olympics,26,2004,Ukraine,8,5,9,22,23.0,21.87
2004 Summer Olympics,26,2004,Romania,8,5,6,19,26.0,18.94
2004 Summer Olympics,26,2004,Greece,6,6,4,16,13.0,15.49
2004 Summer Olympics,26,2004,Brazil,5,2,3,10,12.0,10.73
2004 Summer Olympics,26,2004,Norway,5,0,1,6,10.0,6.41
2004 Summer Olympics,26,2004,Netherlands,4,9,9,22,25.0,21.39
2004 Summer Olympics,26,2004,Sweden,4,2,1,7,12.0,6.94
2004 Summer Olympics,26,2004,Spain,3,11,6,20,11.0,19.99
2004 Summer Olympics,26,2004,Canada,3,6,3,12,14.0,11.83
2004 Summer Olympics,26,2004,Türkiye,3,3,4,10,5.0,9.14
2004 Summer Olympics,26,2004,Poland,3,2,5,10,14.0,10.1
2004 Summer Olympics,26,2004,New Zealand,3,2,0,5,4.0,5.46
2004 Summer Olympics,26,2004,Thailand,3,1,4,8,3.0,8.07
2004 Summer Olympics,26,2004,Belarus,2,5,6,13,17.0,13.63
2004 Summer Olympics,26,2004,Austria,2,4,1,7,3.0,6.91
2004 Summer Olympics,26,2004,Ethiopia,2,3,2,7,8.0,7.0
2004 Summer Olympics,26,2004,Islamic Republic of Iran,2,2,2,6,4.0,6.03
2004 Summer Olympics,26,2004,Slovakia,2,2,2,6,5.0,6.07
2004 Summer Olympics,26,2004,Chinese Taipei,2,2,1,5,5.0,5.0
2004 Summer Olympics,26,2004,Georgia,2,2,0,4,6.0,4.04
2004 Summer Olympics,26,2004,Bulgaria,2,1,9,12,13.0,11.51
2004 Summer Olympics,26,2004,Denmark,2,1,5,8,6.0,8.06
2004 Summer Olympics,26,2004,Jamaica,2,1,2,5,9.0,5.03
2004 Summer Olympics,26,2004,Uzbekistan,2,1,2,5,4.0,5.03
2004 Summer Olympics,26,2004,Morocco,2,1,0,3,5.0,3.03
2004 Summer Olympics,26,2004,Argentina,2,0,4,6,4.0,6.03
2004 Summer Olympics,26,2004,Chile,2,0,1,3,1.0,3.0
2004 Summer Olympics,26,2004,Kazakhstan,1,4,3,8,7.0,8.04
2004 Summer Olympics,26,2004,Kenya,1,4,2,7,7.0,7.11
2004 Summer Olympics,26,2004,Czechia,1,3,5,9,8.0,9.08
2004 Summer Olympics,26,2004,South Africa,1,3,2,6,5.0,6.01
2004 Summer Olympics,26,2004,Croatia,1,2,2,5,2.0,5.02
2004 Summer Olympics,26,2004,Lithuania,1,2,0,3,5.0,3.01
2004 Summer Olympics,26,2004,Egypt,1,1,3,5,1.0,5.0
2004 Summer Olympics,26,2004,Switzerland,1,1,3,5,9.0,4.99
2004 Summer Olympics,26,2004,Indonesia,1,1,2,4,6.0,4.0
2004 Summer Olympics,26,2004,Zimbabwe,1,1,1,3,1.0,3.0
2004 Summer Olympics,26,2004,Azerbaijan,1,0,4,5,3.0,4.97
2004 Summer Olympics,26,2004,Belgium,1,0,2,3,5.0,3.0
2004 Summer Olympics,26,2004,Israel,1,0,1,2,1.0,2.0
2004 Summer Olympics,26,2004,The Bahamas,1,0,1,2,3.0,2.0
2004 Summer Olympics,26,2004,Cameroon,1,0,0,1,1.0,1.0
2004 Summer Olympics,26,2004,Dominican Republic,1,0,0,1,1.0,1.0
2004 Summer Olympics,26,2004,United Arab Emirates,1,0,0,1,0.0,1.0
2004 Summer Olympics,26,2004,Democratic People's Republic of Korea,0,4,1,5,4.0,4.63
2004 Summer Olympics,26,2004,Latvia,0,4,0,4,3.0,3.94
2004 Summer Olympics,26,2004,Mexico,0,3,1,4,6.0,4.1
2004 Summer Olympics,26,2004,Portugal,0,2,1,3,2.0,3.01
2004 Summer Olympics,26,2004,Finland,0,2,0,2,4.0,2.0
2004 Summer Olympics,26,2004,Serbia and Montenegro,0,2,0,2,3.0,2.0
2004 Summer Olympics,26,2004,Slovenia,0,1,3,4,2.0,4.07
2004 Summer Olympics,26,2004,Estonia,0,1,2,3,3.0,3.0
2004 Summer Olympics,26,2004,"Hong Kong, China",0,1,0,1,1.0,1.0
2004 Summer Olympics,26,2004,India,0,1,0,1,1.0,1.0
2004 Summer Olympics,26,2004,Paraguay,0,1,0,1,0.0,1.0
2004 Summer Olympics,26,2004,Colombia,0,0,2,2,1.0,2.0
2004 Summer Olympics,26,2004,Nigeria,0,0,2,2,3.0,2.0
2004 Summer Olympics,26,2004,Venezuela,0,0,2,2,3.0,2.0
2004 Summer Olympics,26,2004,Eritrea,0,0,1,1,0.0,1.0
2004 Summer Olympics,26,2004,Mongolia,0,0,1,1,1.0,1.0
2004 Summer Olympics,26,2004,Syrian Arab Republic,0,0,1,1,1.0,1.0
2004 Summer Olympics,26,2004,Trinidad and Tobago,0,0,1,1,2.0,1.0
2008 Summer Olympics,53,2008,People's Republic of China,48,22,30,100,63.0,95.31
2008 Summer Olympics,53,2008,United States,36,39,37,112,101.0,111.04
2008 Summer Olympics,53,2008,Russian Federation,24,13,23,60,90.0,57.95
2008 Summer Olympics,53,2008,Great Britain,19,13,19,51,30.0,52.42
2008 Summer Olympics,53,2008,Germany,16,11,14,41,49.0,41.74
2008 Summer Olympics,53,2008,Australia,14,15,17,46,50.0,44.58
2008 Summer Olympics,53,2008,Republic of Korea,13,11,8,32,30.0,30.61
2008 Summer Olympics,53,2008,Japan,9,8,8,25,37.0,25.53
2008 Summer Olympics,53,2008,Italy,8,9,10,27,32.0,27.05
2008 Summer Olympics,53,2008,France,7,16,20,43,33.0,43.11
2008 Summer Olympics,53,2008,Netherlands,7,5,4,16,22.0,15.67
2008 Summer Olympics,53,2008,Ukraine,7,4,11,22,22.0,21.61
2008 Summer Olympics,53,2008,Kenya,6,4,6,16,7.0,15.4
2008 Summer Olympics,53,2008,Spain,5,11,3,19,20.0,17.53
2008 Summer Olympics,53,2008,Jamaica,5,4,2,11,5.0,10.98
2008 Summer Olympics,53,2008,Poland,4,5,2,11,10.0,11.01
2008 Summer Olympics,53,2008,Ethiopia,4,2,1,7,7.0,6.89
2008 Summer Olympics,53,2008,Romania,4,1,4,9,19.0,8.98
2008 Summer Olympics,53,2008,Cuba,3,10,17,30,27.0,33.99
2008 Summer Olympics,53,2008,Canada,3,9,8,20,12.0,19.89
2008 Summer Olympics,53,2008,Hungary,3,5,2,10,17.0,9.97
2008 Summer Olympics,53,2008,Norway,3,5,1,9,6.0,8.8
2008 Summer Olympics,53,2008,Brazil,3,4,10,17,10.0,16.78
2008 Summer Olympics,53,2008,Belarus,3,4,7,14,13.0,13.91
2008 Summer Olympics,53,2008,Czechia,3,3,1,7,9.0,6.92
2008 Summer Olympics,53,2008,Slovakia,3,3,0,6,6.0,6.3
2008 Summer Olympics,53,2008,New Zealand,3,2,4,9,5.0,8.85
2008 Summer Olympics,53,2008,Georgia,3,2,2,7,4.0,6.95
2008 Summer Olympics,53,2008,Kazakhstan,2,3,4,9,8.0,8.96
2008 Summer Olympics,53,2008,Denmark,2,2,3,7,8.0,6.94
2008 Summer Olympics,53,2008,Democratic People's Republic of Korea,2,2,2,6,5.0,6.04
2008 Summer Olympics,53,2008,Thailand,2,2,2,6,8.0,6.06
2008 Summer Olympics,53,2008,Mongolia,2,2,0,4,1.0,4.11
2008 Summer Olympics,53,2008,Switzerland,2,1,4,7,5.0,6.81
2008 Summer Olympics,53,2008,Argentina,2,0,4,6,6.0,6.12
2008 Summer Olympics,53,2008,Mexico,2,0,2,4,4.0,4.13
2008 Summer Olympics,53,2008,Belgium,2,0,0,2,3.0,2.02
2008 Summer Olympics,53,2008,Zimbabwe,1,3,0,4,3.0,4.12
2008 Summer Olympics,53,2008,Slovenia,1,2,2,5,4.0,5.02
2008 Summer Olympics,53,2008,Azerbaijan,1,1,4,6,5.0,6.04
2008 Summer Olympics,53,2008,Indonesia,1,1,4,6,4.0,5.99
2008 Summer Olympics,53,2008,Bulgaria,1,1,3,5,12.0,5.01
2008 Summer Olympics,53,2008,Türkiye,1,1,3,5,10.0,5.01
2008 Summer Olympics,53,2008,Chinese Taipei,1,1,2,4,5.0,4.0
2008 Summer Olympics,53,2008,Finland,1,1,2,4,2.0,4.0
2008 Summer Olympics,53,2008,Latvia,1,1,1,3,4.0,3.0
2008 Summer Olympics,53,2008,Dominican Republic,1,1,0,2,1.0,2.0
2008 Summer Olympics,53,2008,Estonia,1,1,0,2,3.0,2.0
2008 Summer Olympics,53,2008,Portugal,1,1,0,2,3.0,2.0
2008 Summer Olympics,53,2008,Trinidad and Tobago,1,1,0,2,1.0,2.0
2008 Summer Olympics,53,2008,India,1,0,2,3,1.0,3.0
2008 Summer Olympics,53,2008,Islamic Republic of Iran,1,0,1,2,6.0,2.0
2008 Summer Olympics,53,2008,Cameroon,1,0,0,1,1.0,1.0
2008 Summer Olympics,53,2008,Panama,1,0,0,1,2.0,1.0
2008 Summer Olympics,53,2008,Tunisia,1,0,0,1,1.0,1.0
2008 Summer Olympics,53,2008,Sweden,0,4,1,5,7.0,4.86
2008 Summer Olympics,53,2008,Lithuania,0,3,2,5,3.0,5.01
2008 Summer Olympics,53,2008,Nigeria,0,3,2,5,2.0,5.01
2008 Summer Olympics,53,2008,Croatia,0,2,3,5,5.0,5.02
2008 Summer Olympics,53,2008,Colombia,0,2,1,3,2.0,3.0
2008 Summer Olympics,53,2008,Greece,0,2,1,3,16.0,3.0
2008 Summer Olympics,53,2008,Armenia,0,1,4,5,1.0,5.03
2008 Summer Olympics,53,2008,Uzbekistan,0,1,3,4,5.0,4.05
2008 Summer Olympics,53,2008,Austria,0,1,2,3,7.0,3.0
2008 Summer Olympics,53,2008,Ireland,0,1,2,3,1.0,3.0
2008 Summer Olympics,53,2008,Kyrgyzstan,0,1,2,3,1.0,3.0
2008 Summer Olympics,53,2008,Serbia,0,1,2,3,0.0,3.0
2008 Summer Olympics,53,2008,Algeria,0,1,1,2,5.0,2.0
2008 Summer Olympics,53,2008,Morocco,0,1,1,2,3.0,2.0
2008 Summer Olympics,53,2008,Tajikistan,0,1,1,2,0.0,2.0
2008 Summer Olympics,53,2008,The Bahamas,0,1,1,2,2.0,2.0
2008 Summer Olympics,53,2008,Chile,0,1,0,1,3.0,1.0
2008 Summer Olympics,53,2008,Ecuador,0,1,0,1,1.0,1.0
2008 Summer Olympics,53,2008,Iceland,0,1,0,1,1.0,1.0
2008 Summer Olympics,53,2008,Malaysia,0,1,0,1,2.0,1.0
2008 Summer Olympics,53,2008,Samoa,0,1,0,1,0.0,1.0
2008 Summer Olympics,53,2008,Singapore,0,1,0,1,1.0,1.0
2008 Summer Olympics,53,2008,South Africa,0,1,0,1,6.0,1.0
2008 Summer Olympics,53,2008,Sudan,0,1,0,1,0.0,1.0
2008 Summer Olympics,53,2008,Vietnam,0,1,0,1,1.0,1.0
2008 Summer Olympics,53,2008,Egypt,0,0,2,2,5.0,2.0
2008 Summer Olympics,53,2008,Afghanistan,0,0,1,1,0.0,1.0
2008 Summer Olympics,53,2008,Israel,0,0,1,1,2.0,1.0
2008 Summer Olympics,53,2008,Mauritius,0,0,1,1,0.0,1.0
2008 Summer Olympics,53,2008,Republic of Moldova,0,0,1,1,2.0,1.0
2008 Summer Olympics,53,2008,Togo,0,0,1,1,0.0,1.0
2008 Summer Olympics,53,2008,Venezuela,0,0,1,1,2.0,1.0
2012 Summer Olympics,54,2012,United States,48,26,30,104,112.0,102.2
2012 Summer Olympics,54,2012,People's Republic of China,39,31,22,92,100.0,93.08
2012 Summer Olympics,54,2012,Great Britain,29,18,18,65,51.0,65.62
2012 Summer Olympics,54,2012,Russian Federation,18,21,26,65,60.0,64.77
2012 Summer Olympics,54,2012,Republic of Korea,13,9,8,30,32.0,30.19
2012 Summer Olympics,54,2012,Germany,11,20,13,44,41.0,44.04
2012 Summer Olympics,54,2012,France,11,11,13,35,43.0,35.06
2012 Summer Olympics,54,2012,Australia,8,15,12,35,46.0,36.62
2012 Summer Olympics,54,2012,Italy,8,9,11,28,27.0,28.04
2012 Summer Olympics,54,2012,Hungary,8,4,6,18,10.0,16.26
2012 Summer Olympics,54,2012,Japan,7,14,17,38,25.0,37.43
2012 Summer Olympics,54,2012,Islamic Republic of Iran,7,5,1,13,2.0,13.47
2012 Summer Olympics,54,2012,Netherlands,6,6,8,20,16.0,20.12
2012 Summer Olympics,54,2012,New Zealand,6,2,5,13,9.0,13.19
2012 Summer Olympics,54,2012,Ukraine,5,4,10,19,22.0,18.8
2012 Summer Olympics,54,2012,Cuba,5,3,7,15,30.0,14.87
2012 Summer Olympics,54,2012,Spain,4,10,6,20,19.0,20.46
2012 Summer Olympics,54,2012,Jamaica,4,5,4,13,11.0,12.55
2012 Summer Olympics,54,2012,Czechia,4,4,3,11,7.0,10.86
2012 Summer Olympics,54,2012,South Africa,4,1,1,6,1.0,6.09
2012 Summer Olympics,54,2012,Democratic People's Republic of Korea,4,0,3,7,6.0,7.34
2012 Summer Olympics,54,2012,Brazil,3,5,9,17,17.0,17.28
2012 Summer Olympics,54,2012,Poland,3,2,6,11,11.0,11.38
2012 Summer Olympics,54,2012,Ethiopia,3,2,3,8,7.0,7.91
2012 Summer Olympics,54,2012,Kazakhstan,3,1,7,11,9.0,11.81
2012 Summer Olympics,54,2012,Croatia,3,1,2,6,5.0,5.98
2012 Summer Olympics,54,2012,Canada,2,6,10,18,20.0,17.91
2012 Summer Olympics,54,2012,Belarus,2,5,3,10,14.0,9.92
2012 Summer Olympics,54,2012,Kenya,2,4,7,13,16.0,12.22
2012 Summer Olympics,54,2012,Denmark,2,4,3,9,7.0,9.09
2012 Summer Olympics,54,2012,Romania,2,4,1,7,9.0,7.23
2012 Summer Olympics,54,2012,Azerbaijan,2,2,5,9,6.0,8.88
2012 Summer Olympics,54,2012,Switzerland,2,2,0,4,7.0,4.04
2012 Summer Olympics,54,2012,Norway,2,1,1,4,9.0,4.02
2012 Summer Olympics,54,2012,Lithuania,2,0,3,5,5.0,5.16
2012 Summer Olympics,54,2012,Tunisia,2,0,1,3,1.0,3.01
2012 Summer Olympics,54,2012,Sweden,1,4,3,8,5.0,8.04
2012 Summer Olympics,54,2012,Colombia,1,3,5,9,3.0,9.02
2012 Summer Olympics,54,2012,Mexico,1,3,4,8,4.0,8.05
2012 Summer Olympics,54,2012,Georgia,1,2,3,6,7.0,6.03
2012 Summer Olympics,54,2012,Ireland,1,1,4,6,3.0,5.9
2012 Summer Olympics,54,2012,Argentina,1,1,2,4,6.0,4.0
2012 Summer Olympics,54,2012,Serbia,1,1,2,4,3.0,4.0
2012 Summer Olympics,54,2012,Slovenia,1,1,2,4,5.0,4.0
2012 Summer Olympics,54,2012,Trinidad and Tobago,1,1,2,4,2.0,4.0
2012 Summer Olympics,54,2012,Türkiye,1,1,1,3,5.0,3.0
2012 Summer Olympics,54,2012,Dominican Republic,1,1,0,2,2.0,2.0
2012 Summer Olympics,54,2012,Chinese Taipei,1,0,1,2,4.0,2.0
2012 Summer Olympics,54,2012,Latvia,1,0,1,2,3.0,2.0
2012 Summer Olympics,54,2012,Algeria,1,0,0,1,2.0,1.0
2012 Summer Olympics,54,2012,Bahrain,1,0,0,1,0.0,1.0
2012 Summer Olympics,54,2012,Grenada,1,0,0,1,0.0,1.0
2012 Summer Olympics,54,2012,The Bahamas,1,0,0,1,2.0,1.0
2012 Summer Olympics,54,2012,Uganda,1,0,0,1,1.0,1.0
2012 Summer Olympics,54,2012,Venezuela,1,0,0,1,1.0,1.0
2012 Summer Olympics,54,2012,Egypt,0,3,1,4,2.0,4.13
2012 Summer Olympics,54,2012,India,0,2,4,6,3.0,6.1
2012 Summer Olympics,54,2012,Mongolia,0,2,3,5,4.0,5.02
2012 Summer Olympics,54,2012,Thailand,0,2,2,4,6.0,4.06
2012 Summer Olympics,54,2012,Bulgaria,0,2,1,3,5.0,3.0
2012 Summer Olympics,54,2012,Finland,0,2,1,3,4.0,3.0
2012 Summer Olympics,54,2012,Indonesia,0,2,1,3,6.0,3.0
2012 Summer Olympics,54,2012,Slovakia,0,1,3,4,6.0,4.0
2012 Summer Olympics,54,2012,Belgium,0,1,2,3,2.0,3.0
2012 Summer Olympics,54,2012,Armenia,0,1,1,2,5.0,2.0
2012 Summer Olympics,54,2012,Estonia,0,1,1,2,2.0,2.0
2012 Summer Olympics,54,2012,Malaysia,0,1,1,2,1.0,2.0
2012 Summer Olympics,54,2012,Puerto Rico,0,1,1,2,1.0,2.0
2012 Summer Olympics,54,2012,Qatar,0,1,1,2,1.0,2.0
2012 Summer Olympics,54,2012,Botswana,0,1,0,1,0.0,1.0
2012 Summer Olympics,54,2012,Cyprus,0,1,0,1,0.0,1.0
2012 Summer Olympics,54,2012,Gabon,0,1,0,1,0.0,1.0
2012 Summer Olympics,54,2012,Guatemala,0,1,0,1,0.0,1.0
2012 Summer Olympics,54,2012,Montenegro,0,1,0,1,0.0,1.0
2012 Summer Olympics,54,2012,Portugal,0,1,0,1,2.0,1.0
2012 Summer Olympics,54,2012,Uzbekistan,0,0,3,3,4.0,3.03
2012 Summer Olympics,54,2012,Greece,0,0,2,2,3.0,2.0
2012 Summer Olympics,54,2012,Singapore,0,0,2,2,1.0,2.0
2012 Summer Olympics,54,2012,Afghanistan,0,0,1,1,1.0,1.0
2012 Summer Olympics,54,2012,Cameroon,0,0,1,1,1.0,1.0
2012 Summer Olympics,54,2012,"Hong Kong, China",0,0,1,1,1.0,1.0
2012 Summer Olympics,54,2012,Kingdom of Saudi Arabia,0,0,1,1,2.0,1.0
2012 Summer Olympics,54,2012,Kuwait,0,0,1,1,1.0,1.0
2012 Summer Olympics,54,2012,Morocco,0,0,1,1,2.0,1.0
2012 Summer Olympics,54,2012,Tajikistan,0,0,1,1,2.0,1.0
2012 Summer Olympics,54,2012,Vietnam,0,0,1,1,1.0,1.0
2016 Summer Olympics,59,2016,United States,46,37,38,121,104.0,119.03
2016 Summer Olympics,59,2016,Great Britain,27,23,17,67,65.0,62.86
2016 Summer Olympics,59,2016,People's Republic of China,26,18,26,70,92.0,67.44
2016 Summer Olympics,59,2016,Russian Federation,19,17,20,56,65.0,58.12
2016 Summer Olympics,59,2016,Germany,17,10,15,42,44.0,44.39
2016 Summer Olympics,59,2016,Japan,12,8,21,41,38.0,35.98
2016 Summer Olympics,59,2016,France,10,18,14,42,35.0,43.59
2016 Summer Olympics,59,2016,Republic of Korea,9,3,9,21,30.0,20.89
2016 Summer Olympics,59,2016,Italy,8,12,8,28,28.0,27.27
2016 Summer Olympics,59,2016,Australia,8,11,10,29,35.0,27.79
2016 Summer Olympics,59,2016,Netherlands,8,7,4,19,20.0,18.61
2016 Summer Olympics,59,2016,Hungary,8,3,4,15,18.0,15.02
2016 Summer Olympics,59,2016,Brazil,7,6,6,19,17.0,19.19
2016 Summer Olympics,59,2016,Spain,7,4,6,17,20.0,15.95
2016 Summer Olympics,59,2016,Kenya,6,6,1,13,13.0,13.14
2016 Summer Olympics,59,2016,Jamaica,6,3,2,11,13.0,11.28
2016 Summer Olympics,59,2016,Croatia,5,3,2,10,6.0,10.24
2016 Summer Olympics,59,2016,Cuba,5,2,4,11,15.0,10.95
2016 Summer Olympics,59,2016,New Zealand,4,9,5,18,13.0,18.84
2016 Summer Olympics,59,2016,Canada,4,3,15,22,18.0,21.02
2016 Summer Olympics,59,2016,Uzbekistan,4,2,7,13,3.0,12.59
2016 Summer Olympics,59,2016,Colombia,3,2,3,8,9.0,8.02
2016 Summer Olympics,59,2016,Switzerland,3,2,2,7,4.0,6.97
2016 Summer Olympics,59,2016,Islamic Republic of Iran,3,1,4,8,13.0,8.65
2016 Summer Olympics,59,2016,Greece,3,1,2,6,2.0,5.9
2016 Summer Olympics,59,2016,Argentina,3,1,0,4,4.0,3.91
2016 Summer Olympics,59,2016,Denmark,2,6,7,15,9.0,15.88
2016 Summer Olympics,59,2016,Sweden,2,6,3,11,8.0,10.63
2016 Summer Olympics,59,2016,South Africa,2,6,2,10,6.0,9.81
2016 Summer Olympics,59,2016,Kazakhstan,2,5,10,17,11.0,17.13
2016 Summer Olympics,59,2016,Ukraine,2,5,4,11,19.0,10.95
2016 Summer Olympics,59,2016,Serbia,2,4,2,8,4.0,8.07
2016 Summer Olympics,59,2016,Poland,2,3,6,11,11.0,10.55
2016 Summer Olympics,59,2016,Democratic People's Republic of Korea,2,3,2,7,7.0,6.97
2016 Summer Olympics,59,2016,Belgium,2,2,2,6,3.0,6.02
2016 Summer Olympics,59,2016,Thailand,2,2,2,6,4.0,6.02
2016 Summer Olympics,59,2016,Slovakia,2,2,0,4,4.0,4.05
2016 Summer Olympics,59,2016,Georgia,2,1,4,7,6.0,6.64
2016 Summer Olympics,59,2016,Azerbaijan,1,7,10,18,9.0,17.87
2016 Summer Olympics,59,2016,Belarus,1,4,4,9,10.0,8.93
2016 Summer Olympics,59,2016,Türkiye,1,3,4,8,3.0,7.97
2016 Summer Olympics,59,2016,Armenia,1,3,0,4,2.0,4.1
2016 Summer Olympics,59,2016,Czechia,1,2,7,10,11.0,10.0
2016 Summer Olympics,59,2016,Ethiopia,1,2,5,8,8.0,8.18
2016 Summer Olympics,59,2016,Slovenia,1,2,1,4,4.0,3.98
2016 Summer Olympics,59,2016,Indonesia,1,2,0,3,3.0,3.01
2016 Summer Olympics,59,2016,Romania,1,1,2,4,7.0,4.0
2016 Summer Olympics,59,2016,Bahrain,1,1,0,2,1.0,2.0
2016 Summer Olympics,59,2016,Vietnam,1,1,0,2,1.0,2.0
2016 Summer Olympics,59,2016,Chinese Taipei,1,0,2,3,2.0,3.01
2016 Summer Olympics,59,2016,Côte d'Ivoire,1,0,1,2,1.0,2.0
2016 Summer Olympics,59,2016,Independent Olympic Athletes,1,0,1,2,3.0,2.0
2016 Summer Olympics,59,2016,The Bahamas,1,0,1,2,1.0,2.0
2016 Summer Olympics,59,2016,Fiji,1,0,0,1,0.0,1.0
2016 Summer Olympics,59,2016,Jordan,1,0,0,1,0.0,1.0
2016 Summer Olympics,59,2016,Kosovo,1,0,0,1,0.0,1.0
2016 Summer Olympics,59,2016,Puerto Rico,1,0,0,1,2.0,1.0
2016 Summer Olympics,59,2016,Singapore,1,0,0,1,2.0,1.0
2016 Summer Olympics,59,2016,Tajikistan,1,0,0,1,1.0,1.0
2016 Summer Olympics,59,2016,Malaysia,0,4,1,5,2.0,4.66
2016 Summer Olympics,59,2016,Mexico,0,3,2,5,8.0,5.03
2016 Summer Olympics,59,2016,Venezuela,0,2,1,3,1.0,3.0
2016 Summer Olympics,59,2016,Algeria,0,2,0,2,1.0,2.0
2016 Summer Olympics,59,2016,Ireland,0,2,0,2,6.0,2.0
2016 Summer Olympics,59,2016,Lithuania,0,1,3,4,5.0,3.99
2016 Summer Olympics,59,2016,Bulgaria,0,1,2,3,3.0,3.0
2016 Summer Olympics,59,2016,India,0,1,1,2,6.0,2.0
2016 Summer Olympics,59,2016,Mongolia,0,1,1,2,5.0,2.0
2016 Summer Olympics,59,2016,Burundi,0,1,0,1,1.0,1.0
2016 Summer Olympics,59,2016,Grenada,0,1,0,1,1.0,1.0
2016 Summer Olympics,59,2016,Niger,0,1,0,1,1.0,1.0
2016 Summer Olympics,59,2016,Philippines,0,1,0,1,1.0,1.0
2016 Summer Olympics,59,2016,Qatar,0,1,0,1,2.0,1.0
2016 Summer Olympics,59,2016,Norway,0,0,4,4,4.0,4.06
2016 Summer Olympics,59,2016,Egypt,0,0,3,3,4.0,3.04
2016 Summer Olympics,59,2016,Tunisia,0,0,3,3,3.0,3.02
2016 Summer Olympics,59,2016,Israel,0,0,2,2,1.0,2.0
2016 Summer Olympics,59,2016,Austria,0,0,1,1,3.0,1.0
2016 Summer Olympics,59,2016,Dominican Republic,0,0,1,1,2.0,1.0
2016 Summer Olympics,59,2016,Estonia,0,0,1,1,2.0,1.0
2016 Summer Olympics,59,2016,Finland,0,0,1,1,3.0,1.0
2016 Summer Olympics,59,2016,Morocco,0,0,1,1,1.0,1.0
2016 Summer Olympics,59,2016,Nigeria,0,0,1,1,5.0,1.0
2016 Summer Olympics,59,2016,Portugal,0,0,1,1,1.0,1.0
2016 Summer Olympics,59,2016,Trinidad and Tobago,0,0,1,1,4.0,1.0
2016 Summer Olympics,59,2016,United Arab Emirates,0,0,1,1,1.0,1.0
2020 Summer Olympics,61,2020,United States,39,41,33,113,121.0,110.11
2020 Summer Olympics,61,2020,People's Republic of China,38,32,19,89,70.0,91.24
2020 Summer Olympics,61,2020,Japan,27,14,17,58,41.0,56.67
2020 Summer Olympics,61,2020,Great Britain,22,20,22,64,67.0,64.18
2020 Summer Olympics,61,2020,ROC,20,28,23,71,0.0,72.15
2020 Summer Olympics,61,2020,Australia,17,7,22,46,29.0,46.1
2020 Summer Olympics,61,2020,Netherlands,10,12,14,36,19.0,35.55
2020 Summer Olympics,61,2020,France,10,12,11,33,42.0,33.12
2020 Summer Olympics,61,2020,Germany,10,11,16,37,42.0,38.48
2020 Summer Olympics,61,2020,Italy,10,10,20,40,28.0,38.91
2020 Summer Olympics,61,2020,Canada,7,7,10,24,22.0,23.37
2020 Summer Olympics,61,2020,Brazil,7,6,8,21,19.0,21.08
2020 Summer Olympics,61,2020,New Zealand,7,6,7,20,18.0,20.35
2020 Summer Olympics,61,2020,Cuba,7,3,5,15,11.0,14.75
2020 Summer Olympics,61,2020,Hungary,6,7,7,20,15.0,19.9
2020 Summer Olympics,61,2020,Republic of Korea,6,4,10,20,21.0,19.8
2020 Summer Olympics,61,2020,Poland,4,5,5,14,11.0,14.34
2020 Summer Olympics,61,2020,Czechia,4,4,3,11,10.0,10.96
2020 Summer Olympics,61,2020,Kenya,4,4,2,10,13.0,9.88
2020 Summer Olympics,61,2020,Norway,4,2,2,8,4.0,7.58
2020 Summer Olympics,61,2020,Jamaica,4,1,4,9,11.0,8.89
2020 Summer Olympics,61,2020,Spain,3,8,6,17,17.0,16.96
2020 Summer Olympics,61,2020,Sweden,3,6,0,9,11.0,9.22
2020 Summer Olympics,61,2020,Switzerland,3,4,6,13,7.0,12.65
2020 Summer Olympics,61,2020,Denmark,3,4,4,11,15.0,10.69
2020 Summer Olympics,61,2020,Croatia,3,3,2,8,10.0,7.93
2020 Summer Olympics,61,2020,Islamic Republic of Iran,3,2,2,7,8.0,7.04
2020 Summer Olympics,61,2020,Serbia,3,1,5,9,8.0,9.39
2020 Summer Olympics,61,2020,Belgium,3,1,3,7,6.0,7.24
2020 Summer Olympics,61,2020,Bulgaria,3,1,2,6,3.0,5.88
2020 Summer Olympics,61,2020,Slovenia,3,1,1,5,4.0,5.05
2020 Summer Olympics,61,2020,Uzbekistan,3,0,2,5,13.0,5.24
2020 Summer Olympics,61,2020,Georgia,2,5,1,8,7.0,8.14
2020 Summer Olympics,61,2020,Chinese Taipei,2,4,6,12,3.0,11.25
2020 Summer Olympics,61,2020,Türkiye,2,2,9,13,8.0,12.96
2020 Summer Olympics,61,2020,Greece,2,1,1,4,6.0,4.03
2020 Summer Olympics,61,2020,Uganda,2,1,1,4,1.0,4.02
2020 Summer Olympics,61,2020,Ecuador,2,1,0,3,1.0,3.07
2020 Summer Olympics,61,2020,Ireland,2,0,2,4,2.0,4.04
2020 Summer Olympics,61,2020,Israel,2,0,2,4,2.0,4.04
2020 Summer Olympics,61,2020,Qatar,2,0,1,3,1.0,3.01
2020 Summer Olympics,61,2020,Kosovo,2,0,0,2,1.0,2.02
2020 Summer Olympics,61,2020,The Bahamas,2,0,0,2,2.0,2.02
2020 Summer Olympics,61,2020,Ukraine,1,6,12,19,11.0,23.04
2020 Summer Olympics,61,2020,Belarus,1,3,3,7,9.0,7.12
2020 Summer Olympics,61,2020,Romania,1,3,0,4,4.0,4.04
2020 Summer Olympics,61,2020,Venezuela,1,3,0,4,3.0,4.04
2020 Summer Olympics,61,2020,India,1,2,4,7,2.0,7.07
2020 Summer Olympics,61,2020,"Hong Kong, China",1,2,3,6,1.0,6.04
2020 Summer Olympics,61,2020,Philippines,1,2,1,4,1.0,3.99
2020 Summer Olympics,61,2020,Slovakia,1,2,1,4,4.0,3.99
2020 Summer Olympics,61,2020,South Africa,1,2,0,3,10.0,3.01
2020 Summer Olympics,61,2020,Austria,1,1,5,7,1.0,7.52
2020 Summer Olympics,61,2020,Egypt,1,1,4,6,3.0,5.93
2020 Summer Olympics,61,2020,Indonesia,1,1,3,5,3.0,4.99
2020 Summer Olympics,61,2020,Ethiopia,1,1,2,4,8.0,4.0
2020 Summer Olympics,61,2020,Portugal,1,1,2,4,1.0,4.0
2020 Summer Olympics,61,2020,Tunisia,1,1,0,2,3.0,2.0
2020 Summer Olympics,61,2020,Estonia,1,0,1,2,1.0,2.0
2020 Summer Olympics,61,2020,Fiji,1,0,1,2,1.0,2.0
2020 Summer Olympics,61,2020,Latvia,1,0,1,2,2.0,2.0
2020 Summer Olympics,61,2020,Thailand,1,0,1,2,6.0,2.0
2020 Summer Olympics,61,2020,Bermuda,1,0,0,1,1.0,1.0
2020 Summer Olympics,61,2020,Morocco,1,0,0,1,1.0,1.0
2020 Summer Olympics,61,2020,Puerto Rico,1,0,0,1,1.0,1.0
2020 Summer Olympics,61,2020,Colombia,0,4,1,5,8.0,4.85
2020 Summer Olympics,61,2020,Azerbaijan,0,3,4,7,18.0,7.0
2020 Summer Olympics,61,2020,Dominican Republic,0,3,2,5,1.0,5.03
2020 Summer Olympics,61,2020,Armenia,0,2,2,4,4.0,4.07
2020 Summer Olympics,61,2020,Kyrgyzstan,0,2,1,3,3.0,3.01
2020 Summer Olympics,61,2020,Mongolia,0,1,3,4,2.0,4.04
2020 Summer Olympics,61,2020,Argentina,0,1,2,3,4.0,3.0
2020 Summer Olympics,61,2020,San Marino,0,1,2,3,0.0,3.0
2020 Summer Olympics,61,2020,Jordan,0,1,1,2,1.0,2.0
2020 Summer Olympics,61,2020,Malaysia,0,1,1,2,5.0,2.0
2020 Summer Olympics,61,2020,Nigeria,0,1,1,2,1.0,2.0
2020 Summer Olympics,61,2020,Bahrain,0,1,0,1,2.0,1.0
2020 Summer Olympics,61,2020,Kingdom of Saudi Arabia,0,1,0,1,1.0,1.0
2020 Summer Olympics,61,2020,Lithuania,0,1,0,1,4.0,1.0
2020 Summer Olympics,61,2020,Namibia,0,1,0,1,2.0,1.0
2020 Summer Olympics,61,2020,North Macedonia,0,1,0,1,1.0,1.0
2020 Summer Olympics,61,2020,Turkmenistan,0,1,0,1,0.0,1.0
2020 Summer Olympics,61,2020,Kazakhstan,0,0,8,8,17.0,8.32
2020 Summer Olympics,61,2020,Mexico,0,0,4,4,5.0,4.1
2020 Summer Olympics,61,2020,Finland,0,0,2,2,1.0,2.0
2020 Summer Olympics,61,2020,Botswana,0,0,1,1,1.0,1.0
2020 Summer Olympics,61,2020,Burkina Faso,0,0,1,1,0.0,1.0
2020 Summer Olympics,61,2020,Côte d'Ivoire,0,0,1,1,2.0,1.0
2020 Summer Olympics,61,2020,Ghana,0,0,1,1,1.0,1.0
2020 Summer Olympics,61,2020,Grenada,0,0,1,1,1.0,1.0
2020 Summer Olympics,61,2020,Kuwait,0,0,1,1,1.0,1.0
2020 Summer Olympics,61,2020,Republic of Moldova,0,0,1,1,1.0,1.0
2020 Summer Olympics,61,2020,Syrian Arab Republic,0,0,1,1,1.0,1.0
1924 Winter Olympics,29,1924,Norway,4,7,6,17,8.0,17.06
1924 Winter Olympics,29,1924,Finland,4,4,3,11,2.0,10.3
1924 Winter Olympics,29,1924,Austria,2,1,0,3,7.0,3.1
1924 Winter Olympics,29,1924,Switzerland,2,0,1,3,13.0,3.0
1924 Winter Olympics,29,1924,United States,1,2,1,4,113.0,4.0
1924 Winter Olympics,29,1924,Great Britain,1,1,2,4,64.0,4.0
1924 Winter Olympics,29,1924,Sweden,1,1,0,2,9.0,2.0
1924 Winter Olympics,29,1924,Canada,1,0,0,1,24.0,1.0
1924 Winter Olympics,29,1924,Mixed team,1,0,0,1,1.0,1.0
1924 Winter Olympics,29,1924,France,0,0,3,3,33.0,3.04
1924 Winter Olympics,29,1924,Belgium,0,0,1,1,7.0,1.0
1928 Winter Olympics,30,1928,Norway,6,4,5,15,17.0,14.86
1928 Winter Olympics,30,1928,United States,2,2,2,6,4.0,6.13
1928 Winter Olympics,30,1928,Sweden,2,2,1,5,2.0,4.97
1928 Winter Olympics,30,1928,Finland,2,1,1,4,11.0,4.0
1928 Winter Olympics,30,1928,Canada,1,0,0,1,1.0,1.0
1928 Winter Olympics,30,1928,France,1,0,0,1,3.0,1.0
1928 Winter Olympics,30,1928,Austria,0,3,1,4,3.0,4.01
1928 Winter Olympics,30,1928,Belgium,0,0,1,1,1.0,1.0
1928 Winter Olympics,30,1928,Czechoslovakia,0,0,1,1,7.0,1.0
1928 Winter Olympics,30,1928,Germany,0,0,1,1,37.0,1.0
1928 Winter Olympics,30,1928,Great Britain,0,0,1,1,4.0,1.0
1928 Winter Olympics,30,1928,Switzerland,0,0,1,1,3.0,1.0
1932 Winter Olympics,31,1932,United States,6,4,2,12,6.0,11.94
1932 Winter Olympics,31,1932,Norway,3,4,3,10,15.0,9.97
1932 Winter Olympics,31,1932,Sweden,1,2,0,3,5.0,3.0
1932 Winter Olympics,31,1932,Canada,1,1,5,7,1.0,7.22
1932 Winter Olympics,31,1932,Finland,1,1,1,3,4.0,3.0
1932 Winter Olympics,31,1932,Austria,1,1,0,2,4.0,2.0
1932 Winter Olympics,31,1932,France,1,0,0,1,1.0,1.0
1932 Winter Olympics,31,1932,Switzerland,0,1,0,1,1.0,1.0
1932 Winter Olympics,31,1932,Germany,0,0,2,2,1.0,2.0
1932 Winter Olympics,31,1932,Hungary,0,0,1,1,20.0,1.0
1936 Winter Olympics,32,1936,Norway,7,5,3,15,10.0,14.7
1936 Winter Olympics,32,1936,Germany,3,3,0,6,2.0,6.24
1936 Winter Olympics,32,1936,Sweden,2,2,3,7,3.0,6.99
1936 Winter Olympics,32,1936,Finland,1,2,3,6,3.0,6.01
1936 Winter Olympics,32,1936,Switzerland,1,2,0,3,1.0,3.0
1936 Winter Olympics,32,1936,Austria,1,1,2,4,2.0,4.0
1936 Winter Olympics,32,1936,Great Britain,1,1,1,3,1.0,3.0
1936 Winter Olympics,32,1936,United States,1,0,3,4,12.0,3.94
1936 Winter Olympics,32,1936,Canada,0,1,0,1,7.0,1.0
1936 Winter Olympics,32,1936,France,0,0,1,1,1.0,1.0
1936 Winter Olympics,32,1936,Hungary,0,0,1,1,1.0,1.0
1948 Winter Olympics,33,1948,Norway,4,3,3,10,15.0,9.97
1948 Winter Olympics,33,1948,Sweden,4,3,3,10,7.0,9.94
1948 Winter Olympics,33,1948,Switzerland,3,4,3,10,3.0,9.73
1948 Winter Olympics,33,1948,United States,3,4,2,9,4.0,9.01
1948 Winter Olympics,33,1948,France,2,1,2,5,1.0,5.0
1948 Winter Olympics,33,1948,Canada,2,0,1,3,1.0,3.0
1948 Winter Olympics,33,1948,Austria,1,3,4,8,4.0,8.13
1948 Winter Olympics,33,1948,Finland,1,3,2,6,6.0,6.02
1948 Winter Olympics,33,1948,Belgium,1,1,0,2,1.0,2.0
1948 Winter Olympics,33,1948,Italy,1,0,0,1,40.0,1.0
1948 Winter Olympics,33,1948,Czechoslovakia,0,1,0,1,1.0,1.0
1948 Winter Olympics,33,1948,Hungary,0,1,0,1,1.0,1.0
1948 Winter Olympics,33,1948,Great Britain,0,0,2,2,3.0,2.0
1952 Winter Olympics,34,1952,Norway,7,3,6,16,10.0,15.81
1952 Winter Olympics,34,1952,United States,4,6,1,11,9.0,11.61
1952 Winter Olympics,34,1952,Finland,3,4,2,9,6.0,9.0
1952 Winter Olympics,34,1952,Germany,3,2,2,7,6.0,7.05
1952 Winter Olympics,34,1952,Austria,2,4,2,8,8.0,8.03
1952 Winter Olympics,34,1952,Canada,1,0,1,2,3.0,2.0
1952 Winter Olympics,34,1952,Italy,1,0,1,2,1.0,2.0
1952 Winter Olympics,34,1952,Great Britain,1,0,0,1,2.0,1.0
1952 Winter Olympics,34,1952,Netherlands,0,3,0,3,36.0,3.23
1952 Winter Olympics,34,1952,Sweden,0,0,4,4,10.0,3.99
1952 Winter Olympics,34,1952,Switzerland,0,0,2,2,10.0,2.0
1952 Winter Olympics,34,1952,France,0,0,1,1,5.0,1.0
1952 Winter Olympics,34,1952,Hungary,0,0,1,1,1.0,1.0
1956 Winter Olympics,35,1956,Soviet Union,7,3,6,16,132.0,16.05
1956 Winter Olympics,35,1956,Austria,4,3,4,11,8.0,10.18
1956 Winter Olympics,35,1956,Finland,3,3,1,7,9.0,6.98
1956 Winter Olympics,35,1956,Switzerland,3,2,1,6,2.0,6.17
1956 Winter Olympics,35,1956,Sweden,2,4,4,10,4.0,9.82
1956 Winter Olympics,35,1956,United States,2,3,2,7,11.0,7.01
1956 Winter Olympics,35,1956,Norway,2,1,1,4,16.0,4.0
1956 Winter Olympics,35,1956,Italy,1,2,0,3,2.0,3.0
1956 Winter Olympics,35,1956,Germany,1,0,1,2,7.0,2.0
1956 Winter Olympics,35,1956,Canada,0,1,2,3,2.0,3.0
1956 Winter Olympics,35,1956,Japan,0,1,0,1,58.0,1.0
1956 Winter Olympics,35,1956,Hungary,0,0,1,1,1.0,1.0
1956 Winter Olympics,35,1956,Poland,0,0,1,1,14.0,1.0
1960 Winter Olympics,36,1960,Soviet Union,7,5,9,21,16.0,21.05
1960 Winter Olympics,36,1960,Germany,4,3,1,8,2.0,7.7
1960 Winter Olympics,36,1960,United States,3,4,3,10,7.0,9.98
1960 Winter Olympics,36,1960,Norway,3,3,0,6,4.0,6.28
1960 Winter Olympics,36,1960,Sweden,3,2,2,7,10.0,7.05
1960 Winter Olympics,36,1960,Finland,2,3,3,8,7.0,8.37
1960 Winter Olympics,36,1960,Canada,2,1,1,4,3.0,4.0
1960 Winter Olympics,36,1960,Switzerland,2,0,0,2,6.0,2.0
1960 Winter Olympics,36,1960,Austria,1,2,3,6,11.0,6.01
1960 Winter Olympics,36,1960,France,1,0,2,3,1.0,3.0
1960 Winter Olympics,36,1960,Netherlands,0,1,1,2,3.0,2.0
1960 Winter Olympics,36,1960,Poland,0,1,1,2,1.0,2.0
1960 Winter Olympics,36,1960,Czechoslovakia,0,1,0,1,1.0,1.0
1960 Winter Olympics,36,1960,Italy,0,0,1,1,3.0,1.0
1964 Winter Olympics,37,1964,Soviet Union,11,8,6,25,21.0,25.08
1964 Winter Olympics,37,1964,Austria,4,5,3,12,6.0,11.94
1964 Winter Olympics,37,1964,Norway,3,6,6,15,6.0,15.12
1964 Winter Olympics,37,1964,Finland,3,4,3,10,8.0,9.95
1964 Winter Olympics,37,1964,France,3,4,0,7,3.0,7.07
1964 Winter Olympics,37,1964,Germany,3,3,3,9,8.0,9.06
1964 Winter Olympics,37,1964,Sweden,3,3,1,7,7.0,7.0
1964 Winter Olympics,37,1964,United States,1,2,4,7,10.0,7.13
1964 Winter Olympics,37,1964,Canada,1,1,1,3,4.0,3.0
1964 Winter Olympics,37,1964,Netherlands,1,1,0,2,2.0,2.0
1964 Winter Olympics,37,1964,Great Britain,1,0,0,1,1.0,1.0
1964 Winter Olympics,37,1964,Italy,0,1,3,4,1.0,4.04
1964 Winter Olympics,37,1964,Democratic People's Republic of Korea,0,1,0,1,7.0,1.0
1964 Winter Olympics,37,1964,Czechoslovakia,0,0,1,1,1.0,1.0
1968 Winter Olympics,38,1968,Norway,6,6,2,14,15.0,13.9
1968 Winter Olympics,38,1968,Soviet Union,5,5,3,13,25.0,13.56
1968 Winter Olympics,38,1968,France,4,3,2,9,7.0,8.5
1968 Winter Olympics,38,1968,Italy,4,0,0,4,4.0,4.13
1968 Winter Olympics,38,1968,Austria,3,4,4,11,12.0,9.86
1968 Winter Olympics,38,1968,Netherlands,3,3,3,9,2.0,8.98
1968 Winter Olympics,38,1968,Sweden,3,2,3,8,7.0,8.04
1968 Winter Olympics,38,1968,West Germany,2,2,3,7,40.0,7.04
1968 Winter Olympics,38,1968,United States,1,5,1,7,7.0,6.89
1968 Winter Olympics,38,1968,East Germany,1,2,2,5,102.0,5.01
1968 Winter Olympics,38,1968,Finland,1,2,2,5,10.0,5.01
1968 Winter Olympics,38,1968,Czechoslovakia,1,2,1,4,1.0,4.0
1968 Winter Olympics,38,1968,Canada,1,1,1,3,3.0,3.0
1968 Winter Olympics,38,1968,Switzerland,0,2,4,6,2.0,6.02
1968 Winter Olympics,38,1968,Romania,0,0,1,1,4.0,1.0
1972 Winter Olympics,39,1972,Soviet Union,8,5,3,16,13.0,16.02
1972 Winter Olympics,39,1972,East Germany,4,3,7,14,5.0,13.85
1972 Winter Olympics,39,1972,Switzerland,4,3,3,10,6.0,9.97
1972 Winter Olympics,39,1972,Netherlands,4,3,2,9,9.0,8.52
1972 Winter Olympics,39,1972,United States,3,2,3,8,7.0,8.04
1972 Winter Olympics,39,1972,West Germany,3,1,1,5,7.0,5.04
1972 Winter Olympics,39,1972,Norway,2,5,5,12,14.0,12.54
1972 Winter Olympics,39,1972,Italy,2,2,1,5,4.0,5.0
1972 Winter Olympics,39,1972,Austria,1,2,2,5,11.0,5.01
1972 Winter Olympics,39,1972,Sweden,1,1,2,4,8.0,4.0
1972 Winter Olympics,39,1972,Japan,1,1,1,3,1.0,3.0
1972 Winter Olympics,39,1972,Czechoslovakia,1,0,2,3,4.0,3.0
1972 Winter Olympics,39,1972,Poland,1,0,0,1,2.0,1.0
1972 Winter Olympics,39,1972,Spain,1,0,0,1,17.0,1.0
1972 Winter Olympics,39,1972,Finland,0,4,1,5,5.0,4.67
1972 Winter Olympics,39,1972,France,0,1,2,3,9.0,3.0
1972 Winter Olympics,39,1972,Canada,0,1,0,1,3.0,1.0
1976 Winter Olympics,40,1976,Soviet Union,13,6,8,27,16.0,25.88
1976 Winter Olympics,40,1976,East Germany,7,5,7,19,14.0,19.27
1976 Winter Olympics,40,1976,United States,3,3,4,10,8.0,9.15
1976 Winter Olympics,40,1976,Norway,3,3,1,7,12.0,7.01
1976 Winter Olympics,40,1976,West Germany,2,5,3,10,5.0,9.86
1976 Winter Olympics,40,1976,Finland,2,4,1,7,5.0,7.0
1976 Winter Olympics,40,1976,Austria,2,2,2,6,5.0,6.18
1976 Winter Olympics,40,1976,Switzerland,1,3,1,5,10.0,5.13
1976 Winter Olympics,40,1976,Netherlands,1,2,3,6,9.0,6.02
1976 Winter Olympics,40,1976,Italy,1,2,1,4,5.0,4.0
1976 Winter Olympics,40,1976,Canada,1,1,1,3,1.0,3.0
1976 Winter Olympics,40,1976,Great Britain,1,0,0,1,1.0,1.0
1976 Winter Olympics,40,1976,Czechoslovakia,0,1,0,1,3.0,1.0
1976 Winter Olympics,40,1976,Liechtenstein,0,0,2,2,0.0,2.0
1976 Winter Olympics,40,1976,Sweden,0,0,2,2,4.0,2.0
1976 Winter Olympics,40,1976,France,0,0,1,1,3.0,1.0
1980 Winter Olympics,41,1980,Soviet Union,10,6,6,22,27.0,22.48
1980 Winter Olympics,41,1980,East Germany,9,7,7,23,19.0,23.12
1980 Winter Olympics,41,1980,United States,6,4,2,12,10.0,12.02
1980 Winter Olympics,41,1980,Austria,3,2,2,7,6.0,7.18
1980 Winter Olympics,41,1980,Sweden,3,0,1,4,2.0,4.17
1980 Winter Olympics,41,1980,Liechtenstein,2,2,0,4,2.0,4.09
1980 Winter Olympics,41,1980,Finland,1,5,3,9,7.0,8.87
1980 Winter Olympics,41,1980,Norway,1,3,6,10,7.0,10.14
1980 Winter Olympics,41,1980,Netherlands,1,2,1,4,6.0,4.0
1980 Winter Olympics,41,1980,Switzerland,1,1,3,5,5.0,5.0
1980 Winter Olympics,41,1980,Great Britain,1,0,0,1,1.0,1.0
1980 Winter Olympics,41,1980,West Germany,0,2,3,5,10.0,5.01
1980 Winter Olympics,41,1980,Italy,0,2,0,2,4.0,2.0
1980 Winter Olympics,41,1980,Canada,0,1,1,2,3.0,2.0
1980 Winter Olympics,41,1980,Hungary,0,1,0,1,1.0,1.0
1980 Winter Olympics,41,1980,Japan,0,1,0,1,3.0,1.0
1980 Winter Olympics,41,1980,Bulgaria,0,0,1,1,6.0,1.0
1980 Winter Olympics,41,1980,Czechoslovakia,0,0,1,1,1.0,1.0
1980 Winter Olympics,41,1980,France,0,0,1,1,1.0,1.0
1984 Winter Olympics,42,1984,East Germany,9,9,6,24,23.0,24.3
1984 Winter Olympics,42,1984,Soviet Union,6,10,9,25,22.0,24.52
1984 Winter Olympics,42,1984,United States,4,4,0,8,12.0,8.09
1984 Winter Olympics,42,1984,Finland,4,3,6,13,9.0,12.91
1984 Winter Olympics,42,1984,Sweden,4,2,2,8,4.0,7.77
1984 Winter Olympics,42,1984,Norway,3,2,4,9,10.0,8.88
1984 Winter Olympics,42,1984,Switzerland,2,2,1,5,5.0,5.0
1984 Winter Olympics,42,1984,Canada,2,1,1,4,2.0,4.01
1984 Winter Olympics,42,1984,West Germany,2,1,1,4,5.0,4.01
1984 Winter Olympics,42,1984,Italy,2,0,0,2,2.0,2.0
1984 Winter Olympics,42,1984,Great Britain,1,0,0,1,1.0,1.0
1984 Winter Olympics,42,1984,Czechoslovakia,0,2,4,6,1.0,6.02
1984 Winter Olympics,42,1984,France,0,1,2,3,1.0,3.0
1984 Winter Olympics,42,1984,Japan,0,1,0,1,1.0,1.0
1984 Winter Olympics,42,1984,Yugoslavia,0,1,0,1,12.0,1.0
1984 Winter Olympics,42,1984,Liechtenstein,0,0,2,2,4.0,2.0
1984 Winter Olympics,42,1984,Austria,0,0,1,1,7.0,1.0
1988 Winter Olympics,43,1988,Soviet Union,11,9,9,29,25.0,28.46
1988 Winter Olympics,43,1988,East Germany,9,10,6,25,24.0,24.65
1988 Winter Olympics,43,1988,Switzerland,5,5,5,15,5.0,15.26
1988 Winter Olympics,43,1988,Finland,4,1,2,7,13.0,6.66
1988 Winter Olympics,43,1988,Sweden,4,0,2,6,8.0,5.87
1988 Winter Olympics,43,1988,Austria,3,5,2,10,1.0,9.68
1988 Winter Olympics,43,1988,Netherlands,3,2,2,7,4.0,7.03
1988 Winter Olympics,43,1988,West Germany,2,4,2,8,4.0,8.0
1988 Winter Olympics,43,1988,United States,2,1,3,6,8.0,6.01
1988 Winter Olympics,43,1988,Italy,2,1,2,5,2.0,5.03
1988 Winter Olympics,43,1988,France,1,0,1,2,3.0,2.0
1988 Winter Olympics,43,1988,Norway,0,3,2,5,9.0,5.05
1988 Winter Olympics,43,1988,Canada,0,2,3,5,4.0,5.01
1988 Winter Olympics,43,1988,Yugoslavia,0,2,1,3,1.0,3.06
1988 Winter Olympics,43,1988,Czechoslovakia,0,1,2,3,6.0,3.0
1988 Winter Olympics,43,1988,Japan,0,0,1,1,1.0,1.0
1988 Winter Olympics,43,1988,Liechtenstein,0,0,1,1,2.0,1.0
1992 Winter Olympics,44,1992,Germany,10,10,6,26,9.0,25.89
1992 Winter Olympics,44,1992,Unified Team,9,6,8,23,112.0,23.35
1992 Winter Olympics,44,1992,Norway,9,6,5,20,5.0,21.76
1992 Winter Olympics,44,1992,Austria,6,7,8,21,10.0,20.29
1992 Winter Olympics,44,1992,United States,5,4,2,11,6.0,11.0
1992 Winter Olympics,44,1992,Italy,4,6,4,14,5.0,13.61
1992 Winter Olympics,44,1992,France,3,5,1,9,2.0,8.92
1992 Winter Olympics,44,1992,Finland,3,1,3,7,7.0,7.19
1992 Winter Olympics,44,1992,Canada,2,3,2,7,5.0,6.94
1992 Winter Olympics,44,1992,Republic of Korea,2,1,1,4,20.0,4.01
1992 Winter Olympics,44,1992,Japan,1,2,4,7,1.0,7.0
1992 Winter Olympics,44,1992,Netherlands,1,1,2,4,7.0,4.0
1992 Winter Olympics,44,1992,Sweden,1,0,3,4,6.0,3.93
1992 Winter Olympics,44,1992,Switzerland,1,0,2,3,15.0,3.04
1992 Winter Olympics,44,1992,People's Republic of China,0,3,0,3,89.0,3.14
1992 Winter Olympics,44,1992,Luxembourg,0,2,0,2,1.0,2.0
1992 Winter Olympics,44,1992,New Zealand,0,1,0,1,20.0,1.0
1992 Winter Olympics,44,1992,Czechoslovakia,0,0,3,3,3.0,3.0
1992 Winter Olympics,44,1992,Democratic People's Republic of Korea,0,0,1,1,1.0,1.0
1992 Winter Olympics,44,1992,Spain,0,0,1,1,1.0,1.0
1994 Winter Olympics,45,1994,Russian Federation,11,8,4,23,56.0,22.37
1994 Winter Olympics,45,1994,Norway,10,11,5,26,20.0,25.38
1994 Winter Olympics,45,1994,Germany,9,7,8,24,26.0,23.83
1994 Winter Olympics,45,1994,Italy,7,5,8,20,14.0,19.93
1994 Winter Olympics,45,1994,United States,6,5,2,13,11.0,13.15
1994 Winter Olympics,45,1994,Republic of Korea,4,1,1,6,4.0,6.0
1994 Winter Olympics,45,1994,Canada,3,6,4,13,7.0,12.67
1994 Winter Olympics,45,1994,Switzerland,3,4,2,9,3.0,8.93
1994 Winter Olympics,45,1994,Austria,2,3,4,9,21.0,8.92
1994 Winter Olympics,45,1994,Sweden,2,1,0,3,4.0,3.02
1994 Winter Olympics,45,1994,Japan,1,2,2,5,7.0,5.01
1994 Winter Olympics,45,1994,Kazakhstan,1,2,0,3,8.0,3.01
1994 Winter Olympics,45,1994,Ukraine,1,0,1,2,19.0,2.0
1994 Winter Olympics,45,1994,Uzbekistan,1,0,0,1,5.0,1.0
1994 Winter Olympics,45,1994,Belarus,0,2,0,2,7.0,2.0
1994 Winter Olympics,45,1994,Finland,0,1,5,6,7.0,6.43
1994 Winter Olympics,45,1994,France,0,1,4,5,9.0,5.0
1994 Winter Olympics,45,1994,Netherlands,0,1,3,4,4.0,4.04
1994 Winter Olympics,45,1994,People's Republic of China,0,1,2,3,3.0,3.0
1994 Winter Olympics,45,1994,Slovenia,0,0,3,3,5.0,3.02
1994 Winter Olympics,45,1994,Great Britain,0,0,2,2,1.0,2.0
1994 Winter Olympics,45,1994,Australia,0,0,1,1,46.0,1.0
1998 Winter Olympics,46,1998,Germany,12,9,8,29,24.0,29.17
1998 Winter Olympics,46,1998,Norway,10,10,5,25,26.0,25.18
1998 Winter Olympics,46,1998,Russian Federation,9,6,3,18,23.0,18.24
1998 Winter Olympics,46,1998,Canada,6,5,4,15,13.0,14.42
1998 Winter Olympics,46,1998,United States,6,3,4,13,13.0,12.53
1998 Winter Olympics,46,1998,Netherlands,5,4,2,11,4.0,11.04
1998 Winter Olympics,46,1998,Japan,5,1,4,10,5.0,10.03
1998 Winter Olympics,46,1998,Austria,3,5,9,17,9.0,17.3
1998 Winter Olympics,46,1998,Republic of Korea,3,1,2,6,6.0,5.98
1998 Winter Olympics,46,1998,Italy,2,6,2,10,20.0,10.2
1998 Winter Olympics,46,1998,Finland,2,4,6,12,6.0,11.75
1998 Winter Olympics,46,1998,Switzerland,2,2,3,7,9.0,7.0
1998 Winter Olympics,46,1998,France,2,1,5,8,5.0,8.02
1998 Winter Olympics,46,1998,Czechia,1,1,1,3,11.0,3.0
1998 Winter Olympics,46,1998,Bulgaria,1,0,0,1,1.0,1.0
1998 Winter Olympics,46,1998,People's Republic of China,0,6,2,8,3.0,8.55
1998 Winter Olympics,46,1998,Sweden,0,2,1,3,3.0,3.04
1998 Winter Olympics,46,1998,Denmark,0,1,0,1,11.0,1.0
1998 Winter Olympics,46,1998,Ukraine,0,1,0,1,2.0,1.0
1998 Winter Olympics,46,1998,Belarus,0,0,2,2,2.0,2.0
1998 Winter Olympics,46,1998,Kazakhstan,0,0,2,2,3.0,2.0
1998 Winter Olympics,46,1998,Australia,0,0,1,1,1.0,1.0
1998 Winter Olympics,46,1998,Belgium,0,0,1,1,2.0,1.0
1998 Winter Olympics,46,1998,Great Britain,0,0,1,1,2.0,1.0
2002 Winter Olympics,47,2002,Norway,13,5,7,25,25.0,24.49
2002 Winter Olympics,47,2002,Germany,12,16,8,36,29.0,32.3
2002 Winter Olympics,47,2002,United States,10,13,11,34,13.0,33.98
2002 Winter Olympics,47,2002,Canada,7,3,7,17,15.0,16.98
2002 Winter Olympics,47,2002,Russian Federation,5,4,4,13,18.0,12.98
2002 Winter Olympics,47,2002,France,4,5,2,11,8.0,11.05
2002 Winter Olympics,47,2002,Italy,4,4,5,13,10.0,13.04
2002 Winter Olympics,47,2002,Finland,4,2,1,7,12.0,6.92
2002 Winter Olympics,47,2002,Netherlands,3,5,0,8,11.0,8.36
2002 Winter Olympics,47,2002,Austria,3,4,10,17,17.0,16.96
2002 Winter Olympics,47,2002,Switzerland,3,2,6,11,7.0,11.04
2002 Winter Olympics,47,2002,Croatia,3,1,0,4,8.0,3.95
2002 Winter Olympics,47,2002,People's Republic of China,2,2,4,8,8.0,8.02
2002 Winter Olympics,47,2002,Republic of Korea,2,2,0,4,6.0,4.04
2002 Winter Olympics,47,2002,Australia,2,0,0,2,1.0,2.0
2002 Winter Olympics,47,2002,Czechia,1,2,0,3,3.0,3.01
2002 Winter Olympics,47,2002,Estonia,1,1,1,3,2.0,3.0
2002 Winter Olympics,47,2002,Great Britain,1,0,1,2,1.0,2.0
2002 Winter Olympics,47,2002,Sweden,0,2,5,7,3.0,7.64
2002 Winter Olympics,47,2002,Bulgaria,0,1,2,3,1.0,3.0
2002 Winter Olympics,47,2002,Japan,0,1,1,2,10.0,2.0
2002 Winter Olympics,47,2002,Poland,0,1,1,2,1.0,2.0
2002 Winter Olympics,47,2002,Belarus,0,0,1,1,2.0,1.0
2002 Winter Olympics,47,2002,Slovenia,0,0,1,1,3.0,1.0
2006 Winter Olympics,49,2006,Germany,11,12,6,29,36.0,28.26
2006 Winter Olympics,49,2006,United States,9,9,7,25,34.0,25.88
2006 Winter Olympics,49,2006,Austria,9,7,7,23,17.0,23.3
2006 Winter Olympics,49,2006,Russian Federation,8,6,8,22,13.0,21.75
2006 Winter Olympics,49,2006,Canada,7,10,7,24,17.0,24.19
2006 Winter Olympics,49,2006,Sweden,7,2,5,14,7.0,14.17
2006 Winter Olympics,49,2006,Republic of Korea,6,3,2,11,4.0,11.14
2006 Winter Olympics,49,2006,Switzerland,5,4,5,14,11.0,14.06
2006 Winter Olympics,49,2006,Italy,5,0,6,11,13.0,11.33
2006 Winter Olympics,49,2006,France,3,2,4,9,11.0,8.98
2006 Winter Olympics,49,2006,Netherlands,3,2,4,9,8.0,8.95
2006 Winter Olympics,49,2006,Estonia,3,0,0,3,3.0,3.1
2006 Winter Olympics,49,2006,Norway,2,8,9,19,25.0,18.71
2006 Winter Olympics,49,2006,People's Republic of China,2,4,5,11,8.0,10.71
2006 Winter Olympics,49,2006,Czechia,1,2,1,4,3.0,3.99
2006 Winter Olympics,49,2006,Croatia,1,2,0,3,4.0,3.01
2006 Winter Olympics,49,2006,Australia,1,0,1,2,2.0,2.0
2006 Winter Olympics,49,2006,Japan,1,0,0,1,2.0,1.0
2006 Winter Olympics,49,2006,Finland,0,6,3,9,7.0,9.18
2006 Winter Olympics,49,2006,Poland,0,1,1,2,2.0,2.0
2006 Winter Olympics,49,2006,Belarus,0,1,0,1,1.0,1.0
2006 Winter Olympics,49,2006,Bulgaria,0,1,0,1,3.0,1.0
2006 Winter Olympics,49,2006,Great Britain,0,1,0,1,2.0,1.0
2006 Winter Olympics,49,2006,Slovakia,0,1,0,1,4.0,1.0
2006 Winter Olympics,49,2006,Ukraine,0,0,2,2,1.0,2.0
2006 Winter Olympics,49,2006,Latvia,0,0,1,1,2.0,1.0
2010 Winter Olympics,57,2010,Canada,14,7,5,26,24.0,25.25
2010 Winter Olympics,57,2010,Germany,10,13,7,30,29.0,29.07
2010 Winter Olympics,57,2010,United States,9,15,13,37,25.0,38.59
2010 Winter Olympics,57,2010,Norway,9,8,6,23,19.0,23.28
2010 Winter Olympics,57,2010,Republic of Korea,6,6,2,14,11.0,13.83
2010 Winter Olympics,57,2010,Switzerland,6,0,3,9,14.0,9.27
2010 Winter Olympics,57,2010,People's Republic of China,5,2,4,11,11.0,10.96
2010 Winter Olympics,57,2010,Sweden,5,2,4,11,14.0,10.97
2010 Winter Olympics,57,2010,Austria,4,6,6,16,23.0,16.09
2010 Winter Olympics,57,2010,Netherlands,4,1,3,8,9.0,7.65
2010 Winter Olympics,57,2010,Russian Federation,3,5,7,15,22.0,14.93
2010 Winter Olympics,57,2010,France,2,3,6,11,9.0,10.92
2010 Winter Olympics,57,2010,Australia,2,1,0,3,2.0,3.04
2010 Winter Olympics,57,2010,Czechia,2,0,4,6,4.0,6.01
2010 Winter Olympics,57,2010,Poland,1,3,2,6,2.0,5.95
2010 Winter Olympics,57,2010,Italy,1,1,3,5,11.0,5.01
2010 Winter Olympics,57,2010,Belarus,1,1,1,3,1.0,3.0
2010 Winter Olympics,57,2010,Slovakia,1,1,1,3,1.0,3.0
2010 Winter Olympics,57,2010,Great Britain,1,0,0,1,1.0,1.0
2010 Winter Olympics,57,2010,Japan,0,3,2,5,1.0,5.0
2010 Winter Olympics,57,2010,Croatia,0,2,1,3,3.0,3.0
2010 Winter Olympics,57,2010,Slovenia,0,2,1,3,1.0,3.0
2010 Winter Olympics,57,2010,Latvia,0,2,0,2,1.0,2.0
2010 Winter Olympics,57,2010,Finland,0,1,4,5,9.0,4.99
2010 Winter Olympics,57,2010,Estonia,0,1,0,1,3.0,1.0
2010 Winter Olympics,57,2010,Kazakhstan,0,1,0,1,2.0,1.0
2014 Winter Olympics,58,2014,Norway,11,6,9,26,23.0,25.89
2014 Winter Olympics,58,2014,Russian Federation,10,10,9,29,15.0,28.89
2014 Winter Olympics,58,2014,Canada,10,10,5,25,26.0,25.45
2014 Winter Olympics,58,2014,United States,9,9,10,28,37.0,28.11
2014 Winter Olympics,58,2014,Netherlands,8,7,9,24,8.0,22.7
2014 Winter Olympics,58,2014,Germany,8,6,5,19,30.0,19.05
2014 Winter Olympics,58,2014,Switzerland,7,2,2,11,9.0,10.65
2014 Winter Olympics,58,2014,Belarus,5,0,1,6,3.0,6.45
2014 Winter Olympics,58,2014,Austria,4,8,5,17,16.0,17.1
2014 Winter Olympics,58,2014,France,4,4,7,15,11.0,14.62
2014 Winter Olympics,58,2014,Poland,4,1,1,6,6.0,6.13
2014 Winter Olympics,58,2014,People's Republic of China,3,4,2,9,11.0,9.11
2014 Winter Olympics,58,2014,Republic of Korea,3,3,2,8,14.0,8.03
2014 Winter Olympics,58,2014,Sweden,2,7,6,15,11.0,15.64
2014 Winter Olympics,58,2014,Czechia,2,4,3,9,6.0,9.02
2014 Winter Olympics,58,2014,Slovenia,2,2,4,8,3.0,7.94
2014 Winter Olympics,58,2014,Japan,1,4,3,8,5.0,8.04
2014 Winter Olympics,58,2014,Finland,1,3,1,5,5.0,4.91
2014 Winter Olympics,58,2014,Great Britain,1,1,3,5,1.0,4.99
2014 Winter Olympics,58,2014,Latvia,1,1,3,5,2.0,4.99
2014 Winter Olympics,58,2014,Ukraine,1,0,1,2,2.0,2.0
2014 Winter Olympics,58,2014,Slovakia,1,0,0,1,3.0,1.0
2014 Winter Olympics,58,2014,Italy,0,2,6,8,5.0,8.61
2014 Winter Olympics,58,2014,Australia,0,2,1,3,3.0,3.0
2014 Winter Olympics,58,2014,Croatia,0,1,0,1,3.0,1.0
2014 Winter Olympics,58,2014,Kazakhstan,0,0,1,1,1.0,1.0
2018 Winter Olympics,60,2018,Norway,14,14,11,39,26.0,37.98
2018 Winter Olympics,60,2018,Germany,14,10,7,31,19.0,30.18
2018 Winter Olympics,60,2018,Canada,11,8,10,29,25.0,28.41
2018 Winter Olympics,60,2018,United States,9,8,6,23,28.0,23.68
2018 Winter Olympics,60,2018,Netherlands,8,6,6,20,24.0,20.0
2018 Winter Olympics,60,2018,Sweden,7,6,1,14,15.0,14.77
2018 Winter Olympics,60,2018,Republic of Korea,5,8,4,17,8.0,15.75
2018 Winter Olympics,60,2018,Switzerland,5,6,4,15,11.0,15.07
2018 Winter Olympics,60,2018,France,5,4,6,15,15.0,14.72
2018 Winter Olympics,60,2018,Austria,5,3,6,14,17.0,13.94
2018 Winter Olympics,60,2018,Japan,4,5,4,13,8.0,12.51
2018 Winter Olympics,60,2018,Italy,3,2,5,10,8.0,10.02
2018 Winter Olympics,60,2018,ROC,2,6,9,17,71.0,17.22
2018 Winter Olympics,60,2018,Czechia,2,2,3,7,9.0,7.06
2018 Winter Olympics,60,2018,Belarus,2,1,0,3,6.0,3.06
2018 Winter Olympics,60,2018,People's Republic of China,1,6,2,9,9.0,9.06
2018 Winter Olympics,60,2018,Slovakia,1,2,0,3,1.0,3.01
2018 Winter Olympics,60,2018,Finland,1,1,4,6,5.0,6.05
2018 Winter Olympics,60,2018,Great Britain,1,0,4,5,5.0,5.12
2018 Winter Olympics,60,2018,Poland,1,0,1,2,6.0,2.0
2018 Winter Olympics,60,2018,Hungary,1,0,0,1,1.0,1.0
2018 Winter Olympics,60,2018,Ukraine,1,0,0,1,2.0,1.0
2018 Winter Olympics,60,2018,Australia,0,2,1,3,3.0,3.0
2018 Winter Olympics,60,2018,Slovenia,0,1,1,2,8.0,2.0
2018 Winter Olympics,60,2018,Belgium,0,1,0,1,1.0,1.0
2018 Winter Olympics,60,2018,New Zealand,0,0,2,2,1.0,2.0
2018 Winter Olympics,60,2018,Spain,0,0,2,2,1.0,2.0
2018 Winter Olympics,60,2018,Kazakhstan,0,0,1,1,1.0,1.0
2018 Winter Olympics,60,2018,Latvia,0,0,1,1,5.0,1.0
2018 Winter Olympics,60,2018,Liechtenstein,0,0,1,1,1.0,1.0
2022 Winter Olympics,62,2022,Norway,16,8,13,37,39.0,38.18
2022 Winter Olympics,62,2022,Germany,12,10,5,27,31.0,27.19
2022 Winter Olympics,62,2022,People's Republic of China,9,4,2,15,9.0,14.37
2022 Winter Olympics,62,2022,United States,8,10,7,25,23.0,25.14
2022 Winter Olympics,62,2022,Sweden,8,5,5,18,14.0,18.25
2022 Winter Olympics,62,2022,Netherlands,8,5,4,17,20.0,16.84
2022 Winter Olympics,62,2022,Austria,7,7,4,18,14.0,17.59
2022 Winter Olympics,62,2022,Switzerland,7,2,6,15,15.0,14.88
2022 Winter Olympics,62,2022,ROC,6,12,14,32,17.0,33.13
2022 Winter Olympics,62,2022,France,5,7,2,14,15.0,13.99
2022 Winter Olympics,62,2022,Canada,4,8,14,26,29.0,25.34
2022 Winter Olympics,62,2022,Japan,3,6,9,18,13.0,17.79
2022 Winter Olympics,62,2022,Italy,2,7,8,17,10.0,16.77
2022 Winter Olympics,62,2022,Republic of Korea,2,5,2,9,17.0,9.06
2022 Winter Olympics,62,2022,Slovenia,2,3,2,7,2.0,6.93
2022 Winter Olympics,62,2022,Finland,2,2,4,8,6.0,8.05
2022 Winter Olympics,62,2022,New Zealand,2,1,0,3,2.0,3.07
2022 Winter Olympics,62,2022,Australia,1,2,1,4,3.0,4.0
2022 Winter Olympics,62,2022,Great Britain,1,1,0,2,5.0,2.0
2022 Winter Olympics,62,2022,Hungary,1,0,2,3,1.0,3.01
2022 Winter Olympics,62,2022,Belgium,1,0,1,2,1.0,2.0
2022 Winter Olympics,62,2022,Czechia,1,0,1,2,7.0,2.0
2022 Winter Olympics,62,2022,Slovakia,1,0,1,2,3.0,2.0
2022 Winter Olympics,62,2022,Belarus,0,2,0,2,3.0,2.0
2022 Winter Olympics,62,2022,Spain,0,1,0,1,2.0,1.0
2022 Winter Olympics,62,2022,Ukraine,0,1,0,1,1.0,1.0
2022 Winter Olympics,62,2022,Estonia,0,0,1,1,1.0,1.0
2022 Winter Olympics,62,2022,Latvia,0,0,1,1,1.0,1.0
2022 Winter Olympics,62,2022,Poland,0,0,1,1,2.0,1.0
1956 Equestrian,48,1956,Sweden,3,0,0,3,18.0,3.12
1956 Equestrian,48,1956,Germany,2,3,1,6,27.0,6.13
1956 Equestrian,48,1956,Great Britain,1,0,2,3,2.0,3.0
1956 Equestrian,48,1956,Italy,0,2,1,3,17.0,3.06
1956 Equestrian,48,1956,Denmark,0,1,0,1,1.0,1.0
1956 Equestrian,48,1956,Canada,0,0,1,1,26.0,1.0
1956 Equestrian,48,1956,Switzerland,0,0,1,1,15.0,1.0
1906 Intercalated,4,1906,France,15,9,16,40,14.0,39.42
1906 Intercalated,4,1906,United States,12,6,6,24,25.0,24.2
1906 Intercalated,4,1906,Greece,8,14,13,35,4.0,34.51
1906 Intercalated,4,1906,Great Britain,8,11,5,24,3.0,24.02
1906 Intercalated,4,1906,Italy,7,6,3,16,3.0,15.77
1906 Intercalated,4,1906,Germany,4,6,5,15,6.0,15.45
1906 Intercalated,4,1906,Switzerland,4,3,1,8,1.0,7.81
1906 Intercalated,4,1906,Austria,3,3,3,9,18.0,8.91
1906 Intercalated,4,1906,Denmark,3,2,1,6,1.0,6.11
1906 Intercalated,4,1906,Sweden,2,5,7,14,3.0,14.2
1906 Intercalated,4,1906,Hungary,2,5,3,10,3.0,9.69
1906 Intercalated,4,1906,Belgium,2,2,3,7,2.0,6.99
1906 Intercalated,4,1906,Finland,2,1,1,4,8.0,4.0
1906 Intercalated,4,1906,Canada,1,1,0,2,1.0,2.0
1906 Intercalated,4,1906,Norway,1,1,0,2,37.0,2.0
1906 Intercalated,4,1906,Netherlands,0,1,2,3,17.0,3.0
1906 Intercalated,4,1906,Australia,0,0,3,3,4.0,3.0
1906 Intercalated,4,1906,Bohemia,0,0,2,2,2.0,2.0
